,CustomerID,Recency,Frequency,Monetary,R,F,M,RFMscore
0,12346.0,325,1,77183.6,5,1,4,10
1,12347.0,34461,33124,784420.0000000001,1,5,5,11
2,12348.0,9459,961,55714.44,2,3,4,9
3,12349.0,1314,5329,128301.15000000001,5,4,4,13
4,12350.0,5270,289,5684.8,3,2,2,7
5,12352.0,13657,7225,213013.40000000002,2,4,4,10
6,12353.0,816,16,356.0,5,1,1,7
7,12354.0,13456,3364,62605.200000000004,2,4,4,10
8,12355.0,2782,169,5972.2,4,1,2,7
9,12356.0,16889,3481,165874.37,2,4,4,10
10,12357.0,4323,17161,813204.77,3,5,5,13
11,12358.0,1807,361,22193.14,4,2,3,9
12,12359.0,44393,60025,1545957.35,1,5,5,11
13,12360.0,15168,16641,343405.74,2,5,5,12
14,12361.0,2870,100,1899.0,4,1,1,6
15,12362.0,28036,70756,1390177.18,1,5,5,11
16,12363.0,4635,529,12696.0,3,2,2,7
17,12364.0,5033,7225,111613.49999999999,3,4,4,11
18,12365.0,6402,484,14110.359999999997,3,2,2,7
19,12367.0,44,121,1857.8999999999996,5,1,1,7
20,12370.0,46956,27556,587962.04,1,5,5,11
21,12371.0,3702,3969,118941.48,3,4,4,11
22,12372.0,10871,2704,67498.08000000002,2,3,4,9
23,12373.0,4354,196,5104.400000000001,3,1,2,6
24,12374.0,825,1089,24516.69,5,3,3,11
25,12375.0,1138,289,7777.5,5,2,2,9
26,12377.0,25932,5929,125365.23999999999,1,4,4,9
27,12378.0,28251,47961,877887.78,1,5,5,11
28,12379.0,5020,1600,34089.6,3,3,3,9
29,12380.0,10489,10816,283380.24000000005,2,4,5,11
30,12381.0,8051,7569,160541.97000000003,2,4,4,10
31,12383.0,30873,9801,183205.44,1,4,4,9
32,12384.0,2058,729,15802.290000000003,4,2,3,9
33,12386.0,3602,100,4019.0,4,1,2,7
34,12388.0,17724,10000,278066.00000000006,2,4,5,11
35,12390.0,2528,1024,17594.88,4,3,3,10
36,12391.0,1953,8649,40888.380000000005,4,4,3,11
37,12393.0,13260,4096,101286.4,2,4,4,10
38,12394.0,4935,729,34356.96,3,2,3,8
39,12395.0,27879,24336,470906.28,1,5,5,11
40,12397.0,11410,15876,303647.4000000001,2,5,5,12
41,12398.0,3825,7225,139031.1,3,4,4,11
42,12399.0,12249,3481,65410.350000000006,2,4,4,10
43,12401.0,1515,25,421.5,4,1,1,6
44,12402.0,3553,121,2481.6,4,1,1,6
45,12403.0,245,25,2138.5,5,1,1,7
46,12405.0,7992,2916,92361.06000000001,2,3,4,9
47,12406.0,10199,11025,358606.5,2,4,5,11
48,12407.0,13101,5929,131525.23999999996,2,4,4,10
49,12408.0,16837,11025,303297.75,2,4,5,11
50,12409.0,15159,11881,1206921.03,2,4,5,11
51,12410.0,8008,676,18026.579999999998,2,2,3,7
52,12412.0,8245,3721,74839.68000000001,2,4,4,10
53,12413.0,9692,1444,28807.8,2,3,3,8
54,12414.0,4607,324,10123.38,3,2,2,7
55,12415.0,129700,512656,89438803.48,1,5,5,11
56,12417.0,31203,36864,700627.2,1,5,5,11
57,12418.0,3808,1156,22731.72,3,3,3,9
58,12420.0,1827,841,17411.31,4,2,3,9
59,12421.0,7320,2025,36316.8,3,3,3,9
60,12422.0,7996,1521,31338.839999999993,2,3,3,8
61,12423.0,26256,15625,232413.75,1,5,5,11
62,12424.0,4860,900,52828.79999999999,3,3,4,10
63,12425.0,2808,1296,27979.199999999997,4,3,3,10
64,12426.0,5820,900,17481.9,3,3,3,9
65,12427.0,4736,961,25599.8,3,3,3,9
66,12428.0,71559,86436,2339199.24,1,5,5,11
67,12429.0,17298,9409,363788.8,2,4,5,11
68,12430.0,473,121,2820.3999999999996,5,1,1,7
69,12431.0,47266,55225,1508688.2500000002,1,5,5,11
70,12432.0,14414,11664,546406.5599999998,2,4,5,11
71,12433.0,64790,176400,5617865.4,1,5,5,11
72,12434.0,7016,2500,40307.0,3,3,3,9
73,12435.0,6416,1296,281876.04000000004,3,3,5,11
74,12436.0,1584,256,8144.160000000002,4,2,2,8
75,12437.0,26723,40000,990282.0,1,5,5,11
76,12438.0,7546,9604,284871.30000000005,3,4,5,12
77,12441.0,4026,121,1909.0500000000002,3,1,1,5
78,12442.0,36,144,2064.7200000000003,5,1,1,7
79,12444.0,20626,31329,885966.42,1,5,5,11
80,12445.0,88,16,533.6,5,1,1,7
81,12446.0,3306,3364,58133.979999999996,4,4,4,12
82,12447.0,6318,676,12388.74,3,2,2,7
83,12448.0,968,484,9887.900000000001,5,2,2,9
84,12449.0,19400,36481,776852.39,1,5,5,11
85,12450.0,1350,64,1583.04,4,1,1,6
86,12451.0,60790,125316,3198574.08,1,5,5,11
87,12452.0,352,484,9472.539999999999,5,2,2,9
88,12453.0,5762,1849,30404.869999999995,3,3,3,9
89,12454.0,840,225,52925.100000000006,5,2,4,11
90,12455.0,18626,8100,222017.40000000002,2,4,4,10
91,12456.0,18025,15625,397630.0,2,5,5,12
92,12457.0,9362,3969,148883.49,2,4,4,10
93,12458.0,6745,1444,36001.2,3,3,3,9
94,12461.0,5330,1225,28940.8,3,3,3,9
95,12462.0,12516,3844,73754.58,2,4,4,10
96,12463.0,13719,6889,111616.74000000002,2,4,4,10
97,12464.0,4744,841,35149.45,3,2,3,8
98,12465.0,4751,2209,34882.93,3,3,3,9
99,12468.0,8654,1444,27722.519999999997,2,3,3,8
100,12471.0,71608,210681,9082990.350000001,1,5,5,11
101,12472.0,68592,114921,2227945.29,1,5,5,11
102,12473.0,15277,27889,655984.35,2,5,5,12
103,12474.0,60422,178084,3090765.9799999995,1,5,5,11
104,12475.0,1908,1296,26041.679999999997,4,3,3,10
105,12476.0,30515,54289,1588225.86,1,5,5,11
106,12477.0,42569,90000,3965922.0000000005,1,5,5,11
107,12478.0,108,1296,24515.640000000003,5,3,3,11
108,12479.0,341,961,16343.2,5,3,3,11
109,12480.0,29868,23716,505371.02,1,5,5,11
110,12481.0,43037,46656,1205241.1199999999,1,5,5,11
111,12483.0,11868,5625,186373.5,2,4,4,10
112,12484.0,58326,117649,1552870.76,1,5,5,11
113,12488.0,2091,3025,71426.30000000002,4,3,4,11
114,12489.0,5040,225,5023.949999999999,3,2,2,7
115,12490.0,31983,60025,1327392.85,1,5,5,11
116,12491.0,988,676,11970.4,5,2,2,9
117,12492.0,1638,400,5264.2,4,2,2,8
118,12493.0,4014,484,9542.28,3,2,2,7
119,12494.0,12664,5929,95949.7,2,4,4,10
120,12497.0,1134,196,14603.399999999998,5,1,3,9
121,12498.0,951,529,9285.1,5,2,2,9
122,12500.0,8793,3721,259727.02000000005,2,4,5,11
123,12501.0,50064,22201,323239.11000000004,1,5,5,11
124,12502.0,28784,21609,547408.89,1,5,5,11
125,12504.0,234,81,4338.45,5,1,2,8
126,12506.0,5336,529,1690.5000000000002,3,2,1,6
127,12507.0,5101,484,28705.82,3,2,3,8
128,12508.0,1921,4624,27055.84,4,4,3,11
129,12509.0,1988,49,1235.5,4,1,1,6
130,12510.0,9993,1089,32424.81,2,3,3,8
131,12512.0,2046,961,4097.58,4,3,2,9
132,12513.0,3920,1225,21430.15,3,3,3,9
133,12514.0,13617,2601,51901.68,2,3,4,9
134,12515.0,5648,256,6139.200000000002,3,2,2,7
135,12516.0,3341,676,34113.56,4,2,3,9
136,12517.0,35131,77841,692366.4,1,5,5,11
137,12518.0,6811,15376,255054.36,3,5,5,13
138,12519.0,1071,289,5624.280000000001,5,2,2,9
139,12520.0,31030,23104,400407.52,1,5,5,11
140,12521.0,5396,1444,22787.839999999997,3,3,3,9
141,12522.0,540,144,2312.6400000000003,5,1,1,7
142,12523.0,14755,11236,189715.62,2,4,4,10
143,12524.0,30181,20736,645943.6799999999,1,5,5,11
144,12526.0,4263,5041,93482.86000000002,3,4,4,11
145,12527.0,4963,324,6276.780000000001,3,2,2,7
146,12528.0,17127,8464,177880.16,2,4,4,10
147,12530.0,11147,4356,109710.48,2,4,4,10
148,12531.0,238,289,2128.74,5,2,1,8
149,12532.0,480,256,5597.280000000001,5,2,2,9
150,12534.0,8190,3969,68618.34000000001,2,4,4,10
151,12535.0,4804,1156,24355.9,3,3,3,9
152,12536.0,15367,68121,3289077.6300000004,2,5,5,12
153,12538.0,609,441,7642.95,5,2,2,9
154,12539.0,72831,74529,1520159.5499999998,1,5,5,11
155,12540.0,74951,228484,6405314.72,1,5,5,11
156,12541.0,7359,2704,51021.36000000001,3,3,3,9
157,12544.0,684,361,7081.300000000002,5,2,2,9
158,12545.0,10006,2500,50019.5,2,3,3,8
159,12546.0,4569,4761,80143.5,3,4,4,11
160,12547.0,2074,64,1662.4,4,1,1,6
161,12548.0,830,25,476.0,5,1,1,7
162,12550.0,4503,3249,54995.310000000005,3,3,4,10
163,12551.0,3570,100,1680.0,4,1,1,6
164,12552.0,779,400,8756.4,5,2,2,9
165,12553.0,33982,36481,705225.48,1,5,5,11
166,12556.0,12515,14161,71347.64,2,4,4,10
167,12557.0,6897,1089,395701.68,3,3,5,11
168,12558.0,77,121,2969.5600000000004,5,1,1,7
169,12559.0,6690,441,11795.909999999998,3,2,2,7
170,12560.0,11120,11025,224071.05000000002,2,4,4,10
171,12561.0,4832,256,3821.6,3,2,2,7
172,12562.0,16603,28224,635332.32,2,5,5,12
173,12564.0,5481,441,9594.9,3,2,2,7
174,12565.0,2592,81,1313.2800000000002,4,1,1,6
175,12566.0,1634,361,6681.349999999999,4,2,2,8
176,12567.0,84995,198916,4192970.8800000004,1,5,5,11
177,12569.0,19108,35344,775441.7200000001,1,5,5,11
178,12571.0,2474,1156,17666.74,4,3,3,10
179,12572.0,2028,3600,61225.2,4,4,4,12
180,12573.0,6356,784,4495.12,3,2,2,7
181,12574.0,3465,121,2402.95,4,1,1,6
182,12576.0,12988,7744,115793.04,2,4,4,10
183,12577.0,26818,21316,91483.59999999999,1,5,4,10
184,12578.0,24024,12996,318574.14,1,4,5,10
185,12579.0,2262,841,12772.18,4,2,2,8
186,12580.0,5904,576,9976.800000000003,3,2,2,7
187,12581.0,585,225,2965.65,5,2,1,8
188,12582.0,5836,484,11249.919999999998,3,2,2,7
189,12583.0,40268,61009,1798500.8599999999,1,5,5,11
190,12584.0,10371,9216,224462.40000000005,2,4,4,10
191,12585.0,27963,7569,177488.69999999998,1,4,4,9
192,12586.0,187,121,2166.34,5,1,1,7
193,12587.0,28,16,576.0,5,1,1,7
194,12588.0,390,100,2149.0,5,1,1,7
195,12589.0,2140,1225,22633.800000000003,4,3,3,10
196,12590.0,14348,4624,670769.68,2,4,5,11
197,12591.0,8242,676,11774.1,2,2,2,6
198,12592.0,2745,324,7876.8,4,2,2,8
199,12593.0,3583,441,8780.099999999999,4,2,2,8
200,12594.0,21544,13924,393909.96,1,4,5,10
201,12596.0,4242,729,16693.29,3,2,3,8
202,12597.0,21692,42436,785111.3199999998,1,5,5,11
203,12598.0,16843,17424,399046.56,2,5,5,12
204,12599.0,10990,3844,64019.96000000002,2,4,4,10
205,12600.0,11680,4096,166338.56,2,4,4,10
206,12601.0,7539,784,16157.680000000002,3,2,3,8
207,12602.0,696,144,1837.44,5,1,1,7
208,12603.0,63,9,2217.6,5,1,1,7
209,12604.0,3084,256,4066.88,4,2,2,8
210,12607.0,6060,10201,159530.51,3,4,4,11
211,12609.0,11436,3600,67611.0,2,4,4,10
212,12610.0,10033,11236,222551.24,2,4,4,10
213,12611.0,3380,4225,77565.8,4,4,4,12
214,12612.0,1406,361,13376.759999999998,4,2,2,8
215,12613.0,22071,23409,511690.14,1,5,5,11
216,12614.0,5540,400,6312.0,3,2,2,7
217,12615.0,8207,11025,240574.95,2,4,5,11
218,12616.0,5262,1024,22825.6,3,3,3,9
219,12617.0,1189,1681,14472.18,5,3,3,11
220,12618.0,231,121,1950.41,5,1,1,7
221,12619.0,8901,8100,327711.6,2,4,5,11
222,12620.0,9142,8464,123225.72,2,4,4,10
223,12621.0,75440,218089,6393075.89,1,5,5,11
224,12622.0,2552,121,1981.0999999999997,4,1,1,6
225,12623.0,4968,324,5491.8,3,2,2,7
226,12624.0,5377,1444,24362.94,3,3,3,9
227,12625.0,23870,7396,230808.52000000002,1,4,4,9
228,12626.0,44368,86436,1946421.1199999999,1,5,5,11
229,12627.0,20817,52900,1030061.9000000001,1,5,5,11
230,12628.0,1503,1681,32244.859999999997,4,3,3,10
231,12630.0,1766,4096,81336.32,4,4,4,12
232,12631.0,1767,961,19855.5,4,3,3,10
233,12633.0,19882,10201,218561.98,1,4,4,9
234,12635.0,11589,10201,170607.18000000002,2,4,4,10
235,12637.0,63820,145924,2293107.8,1,5,5,11
236,12638.0,1287,1521,26195.910000000003,5,3,3,11
237,12639.0,5236,484,10694.2,3,2,2,7
238,12640.0,3664,2809,62252.74,3,3,4,10
239,12641.0,1150,100,1859.0,5,1,1,7
240,12642.0,3418,2209,47623.22,4,3,3,10
241,12643.0,4558,576,80271.35999999999,3,2,4,9
242,12644.0,3999,961,14815.210000000001,3,3,3,9
243,12645.0,12405,5329,129588.14000000001,2,4,4,10
244,12646.0,1260,2025,60613.65,5,3,4,12
245,12647.0,28025,14884,454184.04000000004,1,5,5,11
246,12648.0,3234,441,6679.049999999999,4,2,2,8
247,12649.0,5102,961,19328.81,3,3,3,9
248,12650.0,60,400,6288.8,5,2,2,9
249,12651.0,3006,81,1026.0,4,1,1,6
250,12652.0,15888,2304,44159.04,2,3,3,8
251,12653.0,8732,1849,95023.55,2,3,4,9
252,12654.0,5869,1444,22875.239999999998,3,3,3,9
253,12656.0,13892,15876,510447.42,2,5,5,12
254,12657.0,2424,2209,77229.46,4,3,4,11
255,12658.0,648,1296,24697.8,5,3,3,11
256,12659.0,145,25,458.40000000000003,5,1,1,7
257,12660.0,143,169,3186.2999999999997,5,1,1,7
258,12662.0,36845,52900,885449.4,1,5,5,11
259,12664.0,4683,1369,180629.56,3,3,4,10
260,12665.0,972,9,189.0,5,1,1,7
261,12667.0,1914,1089,20464.290000000005,4,3,3,10
262,12668.0,37229,25921,612951.15,1,5,5,11
263,12669.0,22562,10201,277147.03,1,4,5,10
264,12670.0,10665,8464,275636.60000000003,2,4,5,11
265,12672.0,3290,100,2259.0,4,1,1,6
266,12673.0,7593,1764,25641.84,3,3,3,9
267,12674.0,9833,6889,163559.8,2,4,4,10
268,12676.0,7922,2025,59912.55,3,3,4,10
269,12678.0,23901,27225,2908695.9,1,5,5,11
270,12679.0,12586,2304,53424.96,2,3,4,9
271,12680.0,3613,2704,44866.12000000001,4,3,3,10
272,12681.0,135442,407044,8796450.520000001,1,5,5,11
273,12682.0,91082,274576,6434625.68,1,5,5,11
274,12683.0,64728,118336,2915940.08,1,5,5,11
275,12684.0,12993,11025,239781.15000000002,2,4,5,11
276,12685.0,11625,24649,449503.56,2,5,5,12
277,12686.0,2597,49,623.98,4,1,1,6
278,12688.0,19323,29241,833421.5100000001,1,5,5,11
279,12689.0,5268,5184,89827.92,3,4,4,11
280,12690.0,3280,256,6224.16,4,2,2,8
281,12691.0,6422,1024,33145.6,3,3,3,9
282,12693.0,9196,1521,33380.49,2,3,3,8
283,12694.0,4850,1369,32177.789999999997,3,3,3,9
284,12695.0,3002,729,15716.7,4,2,3,9
285,12697.0,4857,1681,39261.19,3,3,3,9
286,12700.0,28874,71824,1323917.3199999998,1,5,5,11
287,12701.0,7610,2809,42278.630000000005,3,3,3,9
288,12702.0,228,144,2628.0,5,1,1,7
289,12703.0,1491,441,5954.55,4,2,2,8
290,12704.0,8187,7744,205993.92,2,4,4,10
291,12705.0,51760,111556,2294008.8600000003,1,5,5,11
292,12707.0,9603,1089,19912.859999999997,2,3,3,8
293,12708.0,29968,24649,425926.87,1,5,5,11
294,12709.0,32674,42849,2009249.6400000001,1,5,5,11
295,12710.0,12272,5929,88474.54000000002,2,4,4,10
296,12712.0,29416,17689,584685.29,1,5,5,11
297,12713.0,0,1444,32244.9,5,3,3,11
298,12714.0,37074,67081,1219594.7400000002,1,5,5,11
299,12715.0,2120,400,6867.200000000001,4,2,2,8
300,12716.0,6057,4761,72690.81000000001,3,4,4,11
301,12717.0,11219,3025,56703.9,2,3,4,9
302,12718.0,1349,361,4526.75,4,2,2,8
303,12719.0,1275,1521,25153.050000000003,5,3,3,11
304,12720.0,59905,125316,2046732.4200000004,1,5,5,11
305,12721.0,28964,25921,427636.93,1,5,5,11
306,12722.0,6645,2809,52874.39,3,3,4,10
307,12723.0,2803,4761,50029.83,4,4,3,11
308,12724.0,7090,2809,54664.73,3,3,4,10
309,12725.0,8904,576,10267.2,2,2,2,6
310,12726.0,20169,15376,323528.39999999997,1,5,5,11
311,12727.0,30926,19321,553317.2999999999,1,5,5,11
312,12728.0,10703,2116,38471.17999999999,2,3,3,8
313,12729.0,2938,676,11778.260000000002,4,2,2,8
314,12731.0,49404,75076,5177479.34,1,5,5,11
315,12732.0,2148,144,2835.120000000001,4,1,1,6
316,12733.0,5148,484,8446.900000000001,3,2,2,7
317,12734.0,1408,16,441.6,4,1,1,6
318,12735.0,14029,1849,33521.51,2,3,3,8
319,12736.0,1328,16,936.0000000000001,5,1,1,7
320,12738.0,4092,121,1708.85,3,1,1,5
321,12739.0,3741,1444,38495.52,3,3,3,9
322,12740.0,1701,729,11545.2,4,2,2,8
323,12743.0,17554,17161,70757.03,2,5,4,11
324,12744.0,44643,49284,4724002.38,1,5,5,11
325,12747.0,18537,10609,432189.0299999999,2,4,5,11
326,12748.0,571122,19474569,145863727.47,1,5,5,11
327,12749.0,21030,39601,814085.12,1,5,5,11
328,12750.0,1920,225,4138.2,4,2,2,8
329,12752.0,4293,2809,231439.34000000003,3,3,4,10
330,12753.0,45815,38809,4221589.83,1,5,5,11
331,12754.0,18010,3969,189676.62,2,4,4,10
332,12755.0,1205,16,15247.8,5,1,3,9
333,12756.0,344,16,448.32,5,1,1,7
334,12757.0,37800,132496,2851812.6,1,5,5,11
335,12758.0,20212,9409,270784.23000000004,1,4,5,10
336,12759.0,15602,9025,145486.80000000005,2,4,4,10
337,12762.0,861,4761,130997.88000000003,5,4,4,13
338,12763.0,6180,324,8893.44,3,2,2,7
339,12764.0,14220,2025,76224.6,2,3,4,9
340,12766.0,66544,96100,2166785.3,1,5,5,11
341,12769.0,7616,1024,36595.2,3,3,3,9
342,12770.0,2520,144,16217.399999999998,4,1,3,8
343,12772.0,3245,3025,49085.850000000006,4,3,3,10
344,12775.0,12588,4356,91478.64000000001,2,4,4,10
345,12778.0,9059,2500,41111.5,2,3,3,8
346,12779.0,29711,22201,593222.64,1,5,5,11
347,12781.0,4890,625,20668.5,3,2,3,8
348,12782.0,24597,10609,240084.76000000007,1,4,5,10
349,12783.0,3810,7056,186976.44,3,4,4,11
350,12784.0,849,3249,30370.739999999998,5,3,3,11
351,12785.0,5096,196,4367.3,3,1,2,6
352,12787.0,2300,400,9273.2,4,2,2,8
353,12789.0,260,16,367.4,5,1,1,7
354,12790.0,4032,441,6823.3200000000015,3,2,2,7
355,12791.0,746,4,385.2,5,1,1,7
356,12792.0,6400,625,10013.5,3,2,2,7
357,12793.0,8275,576,13091.52,2,2,2,6
358,12794.0,3285,2025,38718.45,4,3,3,10
359,12795.0,252,196,6026.72,5,1,2,8
360,12797.0,4745,169,3302.39,3,1,1,5
361,12798.0,1074,64,55816.32,5,1,4,10
362,12802.0,4650,625,10689.5,3,2,2,7
363,12808.0,4664,784,13542.199999999999,3,2,2,7
364,12809.0,4425,625,12232.75,3,2,2,7
365,12811.0,8412,961,15960.349999999997,2,3,3,8
366,12812.0,660,225,3444.6,5,2,1,8
367,12814.0,202,4,251.84,5,1,1,7
368,12815.0,8490,2209,49982.62,2,3,3,8
369,12816.0,3970,841,16593.800000000003,3,2,3,8
370,12817.0,1124,16,664.16,5,1,1,7
371,12818.0,3654,196,21589.12,3,1,3,7
372,12820.0,5626,3481,55598.060000000005,3,4,4,11
373,12821.0,1284,36,556.3199999999999,5,1,1,7
374,12822.0,3849,2116,43648.48000000001,3,3,3,9
375,12823.0,1040,25,8797.5,5,1,2,8
376,12824.0,1475,625,9928.0,4,2,2,8
377,12826.0,18671,8281,134199.52,2,4,4,10
378,12827.0,845,625,10753.75,5,2,2,9
379,12828.0,3910,3136,57047.76,3,3,4,10
380,12829.0,3816,121,3223.0,3,1,1,5
381,12830.0,5058,1444,258956.32000000004,3,3,5,11
382,12831.0,2358,81,1935.45,4,1,1,6
383,12832.0,2052,729,10341.81,4,2,2,8
384,12833.0,3480,576,10017.119999999999,4,2,2,8
385,12834.0,5076,324,5622.84,3,2,2,7
386,12836.0,31886,30276,454202.64,1,5,5,11
387,12837.0,2076,144,1609.1999999999998,4,1,1,6
388,12838.0,24020,14400,80634.0,1,4,4,9
389,12839.0,40832,98596,1755705.8800000001,1,5,5,11
390,12840.0,22637,12769,308125.01,1,4,5,10
391,12841.0,81341,171396,1652514.1199999999,1,5,5,11
392,12842.0,5712,1156,38045.66,3,3,3,9
393,12843.0,20110,10609,175332.78000000003,1,4,4,9
394,12844.0,4336,2704,16949.92,3,3,3,9
395,12845.0,7699,729,9560.429999999998,3,2,2,7
396,12847.0,1848,7056,70865.76,4,4,4,12
397,12849.0,9546,2304,48493.92,2,3,3,8
398,12851.0,4512,2209,6195.069999999999,3,3,2,8
399,12852.0,4998,289,5296.35,3,2,2,7
400,12853.0,16382,6084,152653.80000000002,2,4,4,10
401,12854.0,23508,11881,143471.25000000003,1,4,4,9
402,12855.0,1116,9,114.30000000000001,5,1,1,7
403,12856.0,12520,96721,675112.5800000001,2,5,5,12
404,12857.0,12788,2116,50894.4,2,3,3,8
405,12863.0,260,25,2606.0,5,1,1,7
406,12864.0,414,9,441.36,5,1,1,7
407,12865.0,8096,9025,148981.85,2,4,4,10
408,12866.0,7358,676,14537.12,3,2,3,8
409,12867.0,97181,285156,2140987.56,1,5,5,11
410,12868.0,29286,11449,171955.42,1,4,4,9
411,12871.0,1416,121,4187.04,4,1,2,7
412,12872.0,22998,4356,39598.02000000001,1,4,3,8
413,12873.0,1128,16,1496.0,5,1,1,7
414,12875.0,505,4,686.4600000000002,5,1,1,7
415,12876.0,9571,7225,188531.70000000007,2,4,4,10
416,12877.0,18783,23716,236508.58000000005,2,5,5,12
417,12878.0,11662,2209,40184.53,2,3,3,8
418,12879.0,739,100,5732.200000000001,5,1,2,8
419,12881.0,1925,49,2086.0,4,1,1,6
420,12882.0,237,169,19019.519999999993,5,1,3,9
421,12883.0,2243,1764,29545.74,4,3,3,10
422,12884.0,616,49,2163.3500000000004,5,1,1,7
423,12885.0,6813,5041,83440.61999999998,3,4,4,11
424,12886.0,12638,6724,113028.8,2,4,4,10
425,12888.0,1234,25,1770.6,5,1,1,7
426,12890.0,1896,6241,29760.88,4,4,3,11
427,12891.0,697,9,993.0,5,1,1,7
428,12893.0,930,961,5473.049999999999,5,3,2,10
429,12895.0,1628,484,8201.6,4,2,2,8
430,12897.0,1010,16,866.0,5,1,1,7
431,12901.0,18674,13456,2047926.6399999997,2,4,5,11
432,12902.0,2640,100,1386.7999999999997,4,1,1,6
433,12904.0,6206,5041,35220.26,3,4,3,10
434,12906.0,3842,3969,183948.03,3,4,4,11
435,12908.0,488,4,1500.0,5,1,1,7
436,12909.0,17275,8281,198258.97,2,4,4,10
437,12910.0,10188,5625,230628.00000000003,2,4,4,10
438,12912.0,458,576,39895.2,5,2,3,10
439,12913.0,5089,2500,124181.5,3,3,4,10
440,12915.0,6168,484,8000.299999999999,3,2,2,7
441,12916.0,24588,10609,303329.85,1,4,5,10
442,12917.0,256,4,1188.0,5,1,1,7
443,12919.0,3204,2500,66759.5,4,3,4,11
444,12920.0,459,729,4395.0599999999995,5,2,2,9
445,12921.0,113892,518400,11942704.8,1,5,5,11
446,12922.0,4508,784,11350.64,3,2,2,7
447,12923.0,1792,784,4838.959999999999,4,2,2,8
448,12924.0,5087,900,28011.000000000004,3,3,3,9
449,12925.0,1790,2025,31232.249999999996,4,3,3,10
450,12928.0,14756,7056,173266.8,2,4,4,10
451,12929.0,2488,64,942.8,4,1,1,6
452,12930.0,3252,625,10395.0,4,2,2,8
453,12931.0,10312,6724,3448588.7199999997,2,4,5,11
454,12933.0,10643,11236,64398.18,2,4,4,10
455,12935.0,19448,16641,278730.3,1,5,5,11
456,12936.0,3071,3844,65961.8,4,4,4,12
457,12937.0,9808,14400,180512.40000000002,2,4,4,10
458,12938.0,225,81,1027.26,5,1,1,7
459,12939.0,9643,2209,544344.6,2,3,5,10
460,12940.0,5811,9216,86370.24,3,4,4,11
461,12942.0,13442,4900,47292.0,2,4,3,9
462,12944.0,5516,900,18135.299999999996,3,3,3,9
463,12945.0,6624,529,10647.850000000002,3,2,2,7
464,12947.0,24602,9409,155587.03,1,4,4,9
465,12948.0,17644,13456,239534.19999999998,2,4,5,11
466,12949.0,36204,46225,895952.3,1,5,5,11
467,12950.0,272,529,42389.0,5,2,3,10
468,12951.0,11957,3969,67036.40999999999,2,4,4,10
469,12952.0,4148,6241,109635.41,3,4,4,11
470,12953.0,153,289,5607.450000000001,5,2,2,9
471,12955.0,17388,32400,856288.8000000002,2,5,5,12
472,12956.0,5814,361,2053.33,3,2,1,6
473,12957.0,31373,56644,956174.52,1,5,5,11
474,12962.0,1278,256,4262.24,5,2,2,9
475,12963.0,8455,9025,176379.85,2,4,4,10
476,12965.0,9612,11664,83139.48000000001,2,4,4,10
477,12966.0,90,100,1601.8000000000002,5,1,1,7
478,12967.0,6997,361,31557.100000000002,3,2,3,8
479,12968.0,560,25,679.75,5,1,1,7
480,12970.0,3423,16641,52305.630000000005,4,5,4,13
481,12971.0,52493,93025,3412922.55,1,5,5,11
482,12974.0,1576,64,1158.4,4,1,1,6
483,12976.0,4642,484,16249.2,3,2,3,8
484,12977.0,1404,81,353.16,4,1,1,6
485,12980.0,5074,400,147498.0,3,2,4,9
486,12981.0,1724,400,7444.399999999998,4,2,2,8
487,12982.0,6776,784,10935.12,3,2,2,7
488,12984.0,72,16,390.0,5,1,1,7
489,12985.0,1456,5776,94192.88,4,4,4,12
490,12987.0,3780,784,15643.600000000002,3,2,3,8
491,12988.0,24236,6889,41983.06000000001,1,4,3,8
492,12989.0,7248,4096,443143.04000000004,3,4,5,12
493,12990.0,1856,169,5323.500000000002,4,1,2,7
494,12991.0,2671,961,15616.560000000003,4,3,3,10
495,12993.0,4721,729,11198.519999999999,3,2,2,7
496,12994.0,8256,3721,59439.619999999995,2,4,4,10
497,12995.0,255,9,633.96,5,1,1,7
498,12997.0,10631,3481,72386.51000000001,2,4,4,10
499,12999.0,6651,784,12764.64,3,2,2,7
500,13000.0,9031,961,16580.350000000006,2,3,3,8
501,13001.0,78659,113569,3297871.8899999997,1,5,5,11
502,13002.0,2226,49,846.65,4,1,1,6
503,13003.0,1112,36,894.3000000000001,5,1,1,7
504,13004.0,70940,163216,2284987.64,1,5,5,11
505,13005.0,5812,676,13356.199999999999,3,2,2,7
506,13006.0,224,16,326.28,5,1,1,7
507,13008.0,4522,196,3212.5800000000004,3,1,1,5
508,13011.0,1116,9,151.64999999999998,5,1,1,7
509,13012.0,12711,7744,144921.91999999998,2,4,4,10
510,13013.0,44235,47961,1053595.8599999999,1,5,5,11
511,13014.0,14672,12100,381290.80000000005,2,4,5,11
512,13015.0,24887,30625,584437.0,1,5,5,11
513,13016.0,4831,2209,37124.829999999994,3,3,3,9
514,13017.0,7,1,204.0,5,1,1,7
515,13018.0,74443,209764,3333186.6000000006,1,5,5,11
516,13021.0,15765,17161,342745.78,2,5,5,12
517,13023.0,3860,1600,27596.000000000004,3,3,3,9
518,13026.0,2900,1600,39014.4,4,3,3,10
519,13027.0,5829,676,179712.0,3,2,4,9
520,13028.0,1542,2025,29759.40000000001,4,3,3,10
521,13029.0,1271,100,12475.0,5,1,2,8
522,13030.0,21361,8464,69224.48,1,4,4,9
523,13032.0,5232,5041,71722.78000000001,3,4,4,11
524,13033.0,3927,121,2096.05,3,1,1,5
525,13034.0,5463,1369,23782.490000000005,3,3,3,9
526,13035.0,4215,729,24890.76,3,2,3,8
527,13037.0,9852,2304,42291.36,2,3,3,8
528,13038.0,6111,784,25436.88,3,2,3,8
529,13040.0,869,1849,29110.57,5,3,3,11
530,13043.0,3549,169,6713.460000000001,4,1,2,7
531,13044.0,9603,1089,18495.510000000002,2,3,3,8
532,13045.0,1782,324,5495.039999999999,4,2,2,8
533,13046.0,4354,1225,22025.85,3,3,3,9
534,13047.0,34221,29584,556856.88,1,5,5,11
535,13048.0,25345,18225,245620.35,1,5,5,11
536,13049.0,2674,196,9193.520000000002,4,1,2,7
537,13050.0,79193,162409,2352254.58,1,5,5,11
538,13052.0,3816,324,6266.700000000001,3,2,2,7
539,13055.0,8898,5776,92295.16,2,4,4,10
540,13058.0,675,64,2171.2,5,1,1,7
541,13059.0,1992,64,1467.2,4,1,1,6
542,13060.0,3795,225,4612.950000000001,3,2,2,7
543,13061.0,720,100,2486.1000000000004,5,1,1,7
544,13062.0,2101,121,3816.78,4,1,2,7
545,13064.0,8343,4624,75180.12,2,4,4,10
546,13065.0,5222,196,2882.04,3,1,1,5
547,13066.0,1376,2304,22598.4,4,3,3,10
548,13067.0,1230,225,1731.8999999999999,5,2,1,8
549,13068.0,329,4,688.0,5,1,1,7
550,13069.0,93232,179776,1878930.5600000003,1,5,5,11
551,13070.0,1728,81,2059.2000000000003,4,1,1,6
552,13072.0,1862,49,1240.0499999999997,4,1,1,6
553,13075.0,2838,484,20231.420000000002,4,2,3,9
554,13077.0,19093,12321,80810.22000000002,1,4,4,9
555,13078.0,62851,128164,4520802.5200000005,1,5,5,11
556,13079.0,406,36,1320.6,5,1,1,7
557,13080.0,1074,36,348.48,5,1,1,7
558,13081.0,199377,1056784,29130826.64,1,5,5,11
559,13082.0,16781,5329,263794.99,2,4,5,11
560,13083.0,1066,324,5467.5,5,2,2,9
561,13085.0,5248,484,9153.76,3,2,2,7
562,13089.0,338980,3290596,106594413.12,1,5,5,11
563,13090.0,20322,24025,1381177.0999999996,1,5,5,11
564,13091.0,588,441,7262.220000000001,5,2,2,9
565,13092.0,6239,625,11945.75,3,2,2,7
566,13093.0,52785,25281,1245362.7300000002,1,5,5,11
567,13094.0,4912,576,46255.68,3,2,3,8
568,13095.0,420,36,446.40000000000003,5,1,1,7
569,13097.0,81583,177241,2527355.62,1,5,5,11
570,13098.0,77017,327184,16520755.68,1,5,5,11
571,13099.0,99,1,207.36,5,1,1,7
572,13101.0,1872,64,809.52,4,1,1,6
573,13102.0,65238,92416,1952923.3599999999,1,5,5,11
574,13103.0,312,64,1951.52,5,1,1,7
575,13104.0,1936,400,21969.6,4,2,3,9
576,13106.0,133,1,76.5,5,1,1,7
577,13107.0,11365,3364,88833.96000000002,2,4,4,10
578,13108.0,3720,100,3500.5999999999995,3,1,1,5
579,13109.0,5125,2209,36967.38,3,3,3,9
580,13110.0,27287,21025,215857.15000000002,1,5,4,10
581,13113.0,43879,40401,2461437.96,1,5,5,11
582,13115.0,12854,14400,275373.60000000003,2,4,5,11
583,13116.0,4140,900,15034.199999999999,3,3,3,9
584,13117.0,19217,5776,74853.16,1,4,4,9
585,13118.0,12548,6241,94626.98999999999,2,4,4,10
586,13120.0,238,1,30.6,5,1,1,7
587,13121.0,13450,2500,14186.5,2,3,2,7
588,13122.0,13054,3025,50731.45,2,3,3,8
589,13124.0,49594,49284,833905.26,1,5,5,11
590,13126.0,22789,19600,293949.6,1,5,5,11
591,13127.0,1155,225,3887.55,5,2,2,9
592,13130.0,188,4,128.0,5,1,1,7
593,13131.0,4124,1936,47225.199999999975,3,3,3,9
594,13132.0,783,9,231.89999999999998,5,1,1,7
595,13133.0,2004,49,768.6,4,1,1,6
596,13134.0,14257,9604,175770.84000000003,2,4,4,10
597,13135.0,196,1,3096.0,5,1,1,7
598,13136.0,15949,16129,331166.47000000003,2,5,5,12
599,13137.0,77511,471969,2475460.23,1,5,5,11
600,13138.0,10683,3969,60630.57,2,4,4,10
601,13139.0,15922,28900,861039.8,2,5,5,12
602,13140.0,8842,2025,19011.15,2,3,3,8
603,13141.0,26641,18225,322481.25,1,5,5,11
604,13142.0,437,529,7063.069999999998,5,2,2,9
605,13144.0,996,9,332.85,5,1,1,7
606,13145.0,811,36,3711.12,5,1,1,7
607,13146.0,442,289,3891.47,5,2,2,9
608,13147.0,182,16,2851.2000000000003,5,1,1,7
609,13148.0,61622,97344,1149177.12,1,5,5,11
610,13149.0,11676,7396,144141.16,2,4,4,10
611,13151.0,21830,5476,93082.38000000002,1,4,4,9
612,13153.0,75,225,7293.3,5,2,2,9
613,13155.0,24184,7225,82599.60000000002,1,4,4,9
614,13157.0,11346,7569,151486.13999999998,2,4,4,10
615,13158.0,13327,6241,94883.73999999999,2,4,4,10
616,13159.0,9596,14400,171522.0,2,4,4,10
617,13160.0,88,16,367.2,5,1,1,7
618,13161.0,2504,64,902.0,4,1,1,6
619,13162.0,19986,6241,133374.90999999997,1,4,4,9
620,13165.0,5897,1764,42902.16,3,3,3,9
621,13166.0,11603,1681,17105.200000000004,2,3,3,8
622,13167.0,6253,4225,51436.45,3,4,4,11
623,13168.0,32803,15876,163748.34,1,5,4,10
624,13169.0,1953,169,9267.44,4,1,2,7
625,13170.0,780,900,3264.3,5,3,1,9
626,13171.0,7724,2116,21546.86,3,3,3,9
627,13173.0,8521,1849,15206.95,2,3,3,8
628,13174.0,79044,85849,803646.2600000001,1,5,5,11
629,13176.0,3082,4489,32259.830000000005,4,4,3,11
630,13177.0,1088,289,4801.65,5,2,2,9
631,13178.0,49964,70225,1517249.5499999998,1,5,5,11
632,13182.0,495,121,1332.98,5,1,1,7
633,13183.0,15909,8836,372031.32000000007,2,4,5,11
634,13184.0,31706,32041,298742.05,1,5,5,11
635,13185.0,267,1,71.4,5,1,1,7
636,13186.0,8268,6241,124495.31000000001,2,4,4,10
637,13187.0,12469,1369,8732.74,2,3,2,7
638,13188.0,22,4,229.2,5,1,1,7
639,13189.0,2268,841,7559.719999999998,4,2,2,8
640,13192.0,9615,3969,57452.22000000001,2,4,4,10
641,13193.0,1525,625,2802.0,4,2,1,7
642,13194.0,405,9,182.10000000000002,5,1,1,7
643,13196.0,14343,12100,197755.8,2,4,4,10
644,13198.0,50175,51076,768680.24,1,5,5,11
645,13199.0,17844,14161,1168237.28,2,4,5,11
646,13200.0,3545,2116,40024.14000000001,4,3,3,10
647,13203.0,4703,3249,49559.219999999994,3,3,3,9
648,13207.0,795,64,2002.08,5,1,1,7
649,13208.0,27998,21904,180212.2,1,5,4,10
650,13209.0,50539,103041,1891206.8099999998,1,5,5,11
651,13210.0,2046,484,7776.56,4,2,2,8
652,13211.0,4907,3025,60248.09999999998,3,3,4,10
653,13212.0,5031,19881,110943.03,3,5,4,12
654,13213.0,10895,8100,136852.19999999998,2,4,4,10
655,13216.0,1335,25,1668.7,4,1,1,6
656,13217.0,540,16,2135.92,5,1,1,7
657,13218.0,635,25,313.2,5,1,1,7
658,13220.0,4018,441,17205.09,3,2,3,8
659,13221.0,20005,4356,55929.060000000005,1,4,4,9
660,13223.0,1032,25,816.0000000000001,5,1,1,7
661,13224.0,10302,11664,232842.59999999998,2,4,5,11
662,13225.0,6363,1024,206842.88,3,3,4,10
663,13226.0,4368,256,1731.36,3,2,1,6
664,13227.0,1809,81,2319.2999999999997,4,1,1,6
665,13228.0,162,4,716.0,5,1,1,7
666,13229.0,2250,100,1609.5,4,1,1,6
667,13230.0,108673,344569,1617554.81,1,5,5,11
668,13232.0,30640,40804,268326.69999999995,1,5,5,11
669,13233.0,7636,1849,26020.159999999996,3,3,3,9
670,13235.0,12296,3364,59802.06000000001,2,4,4,10
671,13236.0,2586,1296,26814.600000000002,4,3,3,10
672,13238.0,3932,961,21722.629999999997,3,3,3,9
673,13239.0,5742,484,7250.32,3,2,2,7
674,13240.0,16400,4489,44464.55,2,4,3,9
675,13242.0,1961,169,3515.2000000000003,4,1,1,6
676,13243.0,11571,3249,33351.840000000004,2,3,3,8
677,13244.0,2484,729,3286.98,4,2,1,7
678,13245.0,800,256,6888.0,5,2,2,9
679,13246.0,29852,18496,266766.72,1,5,5,11
680,13247.0,1559,625,12528.0,4,2,2,8
681,13248.0,4589,676,12107.68,3,2,2,7
682,13249.0,2473,529,16362.429999999998,4,2,3,9
683,13253.0,8544,1296,37094.4,2,3,3,8
684,13255.0,2301,169,5193.63,4,1,2,7
685,13256.0,14,1,0.0,5,1,1,7
686,13258.0,3146,1296,24221.88,4,3,3,10
687,13259.0,4941,6561,22937.58,3,4,3,10
688,13260.0,488,64,4460.96,5,1,2,8
689,13261.0,2548,81,8496.9,4,1,2,7
690,13262.0,2893,121,2203.19,4,1,1,6
691,13263.0,267963,2778889,12397362.31,1,5,5,11
692,13265.0,16061,8100,188339.40000000002,2,4,4,10
693,13266.0,26646,34969,717006.62,1,5,5,11
694,13267.0,36029,44521,954034.3899999999,1,5,5,11
695,13268.0,74831,187489,1374666.75,1,5,5,11
696,13269.0,53522,99225,1683133.2000000002,1,5,5,11
697,13270.0,366,1,590.0,5,1,1,7
698,13271.0,3219,7569,18399.629999999994,4,4,3,11
699,13272.0,929,225,4148.400000000001,5,2,2,9
700,13273.0,1808,256,2223.68,4,2,1,7
701,13276.0,2142,900,17727.899999999998,4,3,3,10
702,13277.0,568,64,2067.2,5,1,1,7
703,13278.0,1840,2116,24965.58,4,3,3,10
704,13279.0,702,81,1239.75,5,1,1,7
705,13280.0,25268,6724,65473.72,1,4,4,9
706,13282.0,4646,1369,41889.18,3,3,3,9
707,13283.0,665,49,655.62,5,1,1,7
708,13284.0,4290,169,2615.47,3,1,1,5
709,13285.0,31865,34969,506605.44000000006,1,5,5,11
710,13291.0,6510,1764,15166.62,3,3,3,9
711,13292.0,4622,961,17947.14,3,3,3,9
712,13294.0,12126,2916,47181.96,2,3,3,8
713,13295.0,3590,100,2012.0,4,1,1,6
714,13296.0,685,25,437.0,5,1,1,7
715,13297.0,2869,3481,123301.15,4,4,4,12
716,13298.0,2,4,720.0,5,1,1,7
717,13299.0,1340,25,712.5,4,1,1,6
718,13300.0,3380,400,7437.799999999999,4,2,2,8
719,13301.0,15942,6561,50065.29,2,4,3,9
720,13302.0,155,1,63.75,5,1,1,7
721,13304.0,7371,441,6308.820000000001,3,2,2,7
722,13305.0,11248,6561,162069.66,2,4,4,10
723,13307.0,120,1,15.0,5,1,1,7
724,13308.0,6224,2916,74817.54,3,3,4,10
725,13309.0,16317,11449,155876.53,2,4,4,10
726,13310.0,14458,5184,81506.16000000002,2,4,4,10
727,13311.0,3608,676,15562.820000000002,4,2,3,9
728,13313.0,11932,6084,121314.95999999999,2,4,4,10
729,13314.0,3376,3844,48108.280000000006,4,4,3,11
730,13316.0,9929,7396,493031.98000000004,2,4,5,11
731,13317.0,20343,15376,281936.32000000007,1,5,5,11
732,13318.0,500,400,12815.200000000003,5,2,2,9
733,13319.0,88987,226576,5162481.8,1,5,5,11
734,13320.0,14002,11025,160880.99999999997,2,4,4,10
735,13321.0,918,121,6240.96,5,1,2,8
736,13322.0,425,625,4987.0,5,2,2,9
737,13323.0,652,441,16544.85,5,2,3,10
738,13324.0,12559,5625,534146.25,2,4,5,11
739,13325.0,972,144,8103.599999999999,5,1,2,8
740,13327.0,21651,11664,391799.16,1,4,5,10
741,13328.0,5372,289,22244.16,3,2,3,8
742,13329.0,2872,289,13413.0,4,2,2,8
743,13330.0,9077,2809,60469.29,2,3,4,9
744,13332.0,294,441,7368.9,5,2,2,9
745,13334.0,59569,70225,928114.8,1,5,5,11
746,13336.0,3927,2601,40551.12,3,3,3,9
747,13338.0,2983,361,9253.38,4,2,2,8
748,13339.0,10800,2916,46446.48,2,3,3,8
749,13340.0,23312,17956,1438688.3199999998,1,5,5,11
750,13341.0,10920,1764,32585.699999999997,2,3,3,8
751,13343.0,3363,361,6715.17,4,2,2,8
752,13344.0,22052,13456,291356.04000000004,1,4,5,10
753,13345.0,5740,400,7790.0,3,2,2,7
754,13347.0,560,64,2730.88,5,1,1,7
755,13348.0,896,196,3272.64,5,1,1,7
756,13349.0,160,256,3957.12,5,2,2,9
757,13350.0,2656,1600,39164.8,4,3,3,10
758,13351.0,1056,256,5983.04,5,2,2,9
759,13352.0,1440,576,9551.52,4,2,2,8
760,13354.0,3621,2601,37920.030000000006,4,3,3,10
761,13355.0,3904,1024,21590.4,3,3,3,9
762,13356.0,3360,1764,32266.080000000005,4,3,3,10
763,13357.0,22873,7921,54236.600000000006,1,4,4,9
764,13358.0,7772,841,12731.869999999999,3,2,2,7
765,13359.0,1449,529,10109.88,4,2,2,8
766,13362.0,27303,27556,513062.83999999997,1,5,5,11
767,13363.0,2034,3600,59550.0,4,4,4,12
768,13364.0,710,100,1349.6000000000001,5,1,1,7
769,13365.0,11400,16384,284847.36,2,5,5,12
770,13366.0,50,1,56.16,5,1,1,7
771,13368.0,7505,841,18078.6,3,2,3,8
772,13369.0,5110,196,4315.92,3,1,2,6
773,13370.0,14469,1521,29439.930000000004,2,3,3,8
774,13372.0,2047,529,8708.719999999998,4,2,2,8
775,13373.0,25768,24964,523335.50000000006,1,5,5,11
776,13375.0,3256,1369,28810.05,4,3,3,10
777,13376.0,9954,2809,54047.28,2,3,4,9
778,13379.0,5842,9409,55538.31999999999,3,4,4,11
779,13381.0,24312,29584,625961.32,1,5,5,11
780,13382.0,4200,225,3344.8500000000004,3,2,1,6
781,13384.0,16905,23104,631093.3600000001,2,5,5,12
782,13385.0,11515,1225,18709.949999999997,2,3,3,8
783,13388.0,4585,1225,23698.5,3,3,3,9
784,13389.0,5799,2601,40695.96,3,3,3,9
785,13390.0,962,169,7073.040000000001,5,1,2,8
786,13391.0,203,1,59.8,5,1,1,7
787,13394.0,22917,24025,390603.1000000001,1,5,5,11
788,13395.0,3885,441,6462.120000000001,3,2,2,7
789,13396.0,5597,1849,58522.57,3,3,4,10
790,13397.0,7834,1444,58676.94,3,3,4,10
791,13398.0,4992,676,11890.84,3,2,2,7
792,13402.0,9118,1521,24227.97000000001,2,3,3,8
793,13403.0,51,9,225.0,5,1,1,7
794,13404.0,1910,121,2777.3900000000003,4,1,1,6
795,13405.0,5926,729,15456.176999999998,3,2,3,8
796,13408.0,79023,228484,13439945.120000001,1,5,5,11
797,13410.0,4729,784,28085.680000000004,3,2,3,8
798,13411.0,1926,324,3843.9,4,2,2,8
799,13414.0,3427,576,33372.0,4,2,3,9
800,13416.0,1235,361,13537.5,5,2,2,9
801,13417.0,2122,784,17943.24,4,2,3,9
802,13418.0,57287,92416,1862738.7200000002,1,5,5,11
803,13419.0,1008,256,3536.96,5,2,1,8
804,13420.0,1276,64,1278.8,5,1,1,7
805,13421.0,20080,10404,187038.42,1,4,4,9
806,13422.0,8128,16129,333540.10000000003,2,5,5,12
807,13425.0,15066,6084,126688.38000000003,2,4,4,10
808,13426.0,25370,24649,571687.24,1,5,5,11
809,13427.0,3729,841,16895.4,3,2,3,8
810,13428.0,710,5041,14326.38,5,4,2,11
811,13429.0,3298,4489,67455.59999999999,4,4,4,12
812,13430.0,2854,2401,33293.049999999996,4,3,3,10
813,13431.0,3838,2116,58378.6,3,3,4,10
814,13434.0,850,100,5342.4,5,1,2,8
815,13435.0,8290,10201,384798.89,2,4,5,11
816,13436.0,12,144,2362.68,5,1,1,7
817,13437.0,21806,27889,569146.02,1,5,5,11
818,13439.0,13770,2916,15320.339999999998,2,3,3,8
819,13441.0,1183,169,3856.3200000000006,5,1,2,8
820,13447.0,1769,3481,66619.26000000002,4,4,4,12
821,13448.0,28332,37636,685729.8600000001,1,5,5,11
822,13449.0,437,361,5545.720000000001,5,2,2,9
823,13450.0,9567,5041,145104.12,2,4,4,10
824,13451.0,80332,187489,1254946.58,1,5,5,11
825,13452.0,529,4,1180.0,5,1,1,7
826,13453.0,3797,289,6068.66,3,2,2,7
827,13455.0,11364,2116,48683.64,2,3,3,8
828,13456.0,6147,3969,111303.36,3,4,4,11
829,13458.0,76609,145924,3684989.7399999998,1,5,5,11
830,13460.0,713,289,3118.48,5,2,1,8
831,13461.0,3026,729,39015.00000000001,4,2,3,9
832,13462.0,2268,81,1363.5,4,1,1,6
833,13464.0,2378,1681,27661.88,4,3,3,10
834,13466.0,3128,289,5234.3,4,2,2,8
835,13467.0,3008,9604,105047.18000000001,4,4,4,12
836,13468.0,64203,91204,1722900.9399999997,1,5,5,11
837,13470.0,1102,100,1650.0,5,1,1,7
838,13471.0,5284,64516,635467.36,3,5,5,13
839,13473.0,4524,441,8875.44,3,2,2,7
840,13474.0,14632,3844,14064.079999999996,2,4,2,8
841,13475.0,21751,7396,123133.08000000002,1,4,4,9
842,13476.0,13311,3364,71831.26,2,4,4,10
843,13477.0,11771,6241,114911.82,2,4,4,10
844,13479.0,3272,225,4514.25,4,2,2,8
845,13481.0,17863,11881,196697.04,2,4,4,10
846,13482.0,2552,121,2031.04,4,1,1,6
847,13483.0,650,100,1403.4,5,1,1,7
848,13484.0,1928,64,2510.4,4,1,1,6
849,13485.0,5359,529,10447.52,3,2,2,7
850,13486.0,8387,4761,77446.29000000001,2,4,4,10
851,13487.0,7222,1156,19563.600000000002,3,3,3,9
852,13488.0,85007,178084,3784626.82,1,5,5,11
853,13489.0,2996,196,6293.28,4,1,2,7
854,13491.0,23228,7396,104560.51999999997,1,4,4,9
855,13492.0,8295,2500,63491.99999999999,2,3,4,9
856,13493.0,2248,64,4949.04,4,1,2,7
857,13494.0,5598,324,5692.680000000001,3,2,2,7
858,13495.0,9976,2304,98153.76,2,3,4,9
859,13496.0,9424,1225,22866.549999999996,2,3,3,8
860,13497.0,6132,361,6612.949999999999,3,2,2,7
861,13499.0,5966,1764,48682.619999999995,3,3,3,9
862,13500.0,3709,4225,75840.05,3,4,4,11
863,13501.0,14976,2704,69696.64,2,3,4,9
864,13502.0,2806,324,5255.999999999999,4,2,2,8
865,13503.0,1207,289,3686.45,5,2,1,8
866,13504.0,1408,484,6510.460000000001,4,2,2,8
867,13505.0,31698,46225,944630.4500000001,1,5,5,11
868,13506.0,9117,676,11921.52,2,2,2,6
869,13507.0,16734,26244,401623.92,2,5,5,12
870,13508.0,2916,144,1331.6400000000006,4,1,1,6
871,13509.0,8294,1936,43107.68,2,3,3,8
872,13510.0,10645,13225,206029.4,2,4,4,10
873,13512.0,3900,225,3768.15,3,2,2,7
874,13513.0,1260,100,2051.0,5,1,1,7
875,13514.0,292,16,608.8000000000001,5,1,1,7
876,13515.0,7792,3481,52576.08,3,4,4,11
877,13516.0,4024,1936,61134.040000000015,3,3,4,10
878,13517.0,18943,19881,300107.22000000003,1,5,5,11
879,13518.0,3060,1296,22577.760000000002,4,3,3,10
880,13519.0,624,64,982.0,5,1,1,7
881,13520.0,19499,8649,337064.55,1,4,5,10
882,13521.0,1960,174724,447983.14,4,5,5,14
883,13522.0,150,25,629.0,5,1,1,7
884,13523.0,27917,29584,681959.36,1,5,5,11
885,13524.0,3538,729,18364.86,4,2,3,9
886,13525.0,552,36,3772.68,5,1,2,8
887,13527.0,24678,47089,486592.12000000005,1,5,5,11
888,13529.0,2052,225,4616.4,4,2,2,8
889,13531.0,6925,484,10643.600000000002,3,2,2,7
890,13532.0,2178,4356,13880.46,4,4,2,10
891,13533.0,17220,5625,20181.750000000004,2,4,3,9
892,13534.0,54266,87616,1737543.68,1,5,5,11
893,13536.0,4630,31684,613101.4199999999,3,5,5,13
894,13538.0,4128,625,32021.249999999996,3,2,3,8
895,13539.0,7159,1369,23359.58,3,3,3,9
896,13544.0,11484,6084,21532.68,2,4,3,9
897,13546.0,7405,9409,60245.73,3,4,4,11
898,13548.0,20775,15129,83413.68,1,5,4,10
899,13549.0,8525,2601,46828.200000000004,2,3,3,8
900,13551.0,1276,16,367.2,5,1,1,7
901,13552.0,18160,11881,407667.63,2,4,5,11
902,13555.0,16895,18225,553348.8,2,5,5,12
903,13557.0,4984,1156,19858.039999999997,3,3,3,9
904,13558.0,6847,28561,100473.87999999999,3,5,4,12
905,13560.0,224,1024,5485.44,5,3,2,10
906,13561.0,3010,196,1986.0400000000002,4,1,1,6
907,13562.0,12318,6724,147545.06,2,4,4,10
908,13563.0,6300,2401,38098.97,3,3,3,9
909,13564.0,29024,6561,139698.27000000002,1,4,4,9
910,13565.0,4817,1444,9128.36,3,3,2,8
911,13566.0,11212,28561,144805.96000000002,2,5,4,11
912,13568.0,7439,1849,8043.150000000001,3,3,2,8
913,13569.0,9393,6241,26750.979999999996,2,4,3,9
914,13570.0,6561,729,6466.230000000001,3,2,2,7
915,13571.0,34686,115600,710239.6,1,5,5,11
916,13572.0,6765,1089,45680.24999999999,3,3,3,9
917,13573.0,1859,625,7256.25,4,2,2,8
918,13575.0,3805,2116,33675.22,3,3,3,9
919,13576.0,20155,15876,846384.84,1,5,5,11
920,13577.0,11000,6889,140070.8,2,4,4,10
921,13579.0,3517,529,10741.920000000002,4,2,2,8
922,13581.0,3090,100,1180.0,4,1,1,6
923,13583.0,8215,2809,41394.59,2,3,3,8
924,13584.0,7344,576,3417.6000000000004,3,2,1,6
925,13587.0,504,64,5699.2,5,1,2,8
926,13588.0,16862,30276,431337.3,2,5,5,12
927,13589.0,1779,441,7972.65,4,2,2,8
928,13590.0,12469,7569,172427.03999999998,2,4,4,10
929,13591.0,10458,3364,64793.53999999998,2,4,4,10
930,13592.0,3172,256,3967.36,4,2,2,8
931,13593.0,27761,16129,255508.7600000001,1,5,5,11
932,13594.0,1352,676,10321.220000000001,4,2,2,8
933,13596.0,1626,21316,96960.06,4,5,4,13
934,13598.0,1645,1225,5601.4000000000015,4,3,2,9
935,13599.0,27986,60516,1266880.32,1,5,5,11
936,13600.0,5928,361,4170.88,3,2,2,7
937,13601.0,11427,9801,68638.68000000001,2,4,4,10
938,13602.0,1472,529,9864.47,4,2,2,8
939,13603.0,702,729,4437.18,5,2,2,9
940,13606.0,9282,1600,11070.0,2,3,2,7
941,13607.0,3880,9409,65524.47000000001,3,4,4,11
942,13610.0,32904,46225,232700.94999999998,1,5,5,11
943,13611.0,11835,5184,83116.8,2,4,4,10
944,13614.0,19319,38025,309164.7,1,5,5,11
945,13615.0,7314,529,9606.870000000003,3,2,2,7
946,13617.0,4675,1936,23943.920000000002,3,3,3,9
947,13618.0,2249,169,2305.42,4,1,1,6
948,13621.0,2204,361,4063.15,4,2,2,8
949,13623.0,16696,6084,56763.719999999994,2,4,4,10
950,13626.0,4788,361,4887.370000000001,3,2,2,7
951,13627.0,17544,8464,150739.24,2,4,4,10
952,13629.0,9415,3481,459749.24000000005,2,4,5,11
953,13630.0,14604,5041,144256.38,2,4,4,10
954,13631.0,1947,121,33774.62,4,1,3,8
955,13632.0,20728,21025,307244.85000000003,1,5,5,11
956,13634.0,28836,34596,287808.95999999996,1,5,5,11
957,13635.0,4154,3844,66403.86,3,4,4,11
958,13636.0,10771,3969,59794.56,2,4,4,10
959,13637.0,19851,9801,79625.7,1,4,4,9
960,13638.0,120,64,981.12,5,1,1,7
961,13639.0,2960,1600,41333.6,4,3,3,10
962,13642.0,12255,3249,17799.960000000003,2,3,3,8
963,13643.0,2328,784,14544.320000000002,4,2,3,9
964,13644.0,9302,21316,383141.96,2,5,5,12
965,13645.0,600,25,1260.5,5,1,1,7
966,13647.0,9211,6084,128553.36000000003,2,4,4,10
967,13649.0,7538,529,7971.8,3,2,2,7
968,13650.0,12076,9216,176288.63999999998,2,4,4,10
969,13651.0,230,36,565.2,5,1,1,7
970,13652.0,12869,3969,68990.04,2,4,4,10
971,13654.0,24776,27556,449416.77999999997,1,5,5,11
972,13655.0,9051,3136,52246.32,2,3,4,9
973,13656.0,13399,2401,18602.85,2,3,3,8
974,13657.0,1879,256,6114.24,4,2,2,8
975,13658.0,11012,11664,285030.36000000004,2,4,5,11
976,13659.0,28130,10609,160989.0,1,4,4,9
977,13662.0,9537,2704,45825.52,2,3,3,8
978,13663.0,2327,169,2463.11,4,1,1,6
979,13666.0,2536,144,1015.8000000000001,4,1,1,6
980,13667.0,12367,6889,24821.149999999998,2,4,3,9
981,13668.0,77770,214369,2921451.29,1,5,5,11
982,13669.0,747,81,1966.95,5,1,1,7
983,13670.0,1875,625,8742.5,4,2,2,8
984,13672.0,1899,36,1118.34,4,1,1,6
985,13673.0,1584,3600,23246.4,4,4,3,11
986,13675.0,5770,625,12170.500000000002,3,2,2,7
987,13678.0,2416,256,3721.6,4,2,1,7
988,13680.0,26168,37636,721509.28,1,5,5,11
989,13681.0,3909,3249,47186.310000000005,3,3,3,9
990,13682.0,561,9,178.5,5,1,1,7
991,13684.0,8265,841,1888.7700000000002,2,2,1,5
992,13685.0,1310,1521,121658.16,5,3,4,12
993,13686.0,1456,64,576.0,4,1,1,6
994,13689.0,378,36,5460.0,5,1,2,8
995,13690.0,531,81,1550.25,5,1,1,7
996,13692.0,8033,2809,78880.95999999999,2,3,4,9
997,13694.0,108022,322624,36942504.160000004,1,5,5,11
998,13695.0,11523,8100,225371.7,2,4,4,10
999,13697.0,456,144,1815.6000000000001,5,1,1,7
1000,13699.0,2170,196,4320.12,4,1,2,7
1001,13700.0,36020,37636,436234.22000000003,1,5,5,11
1002,13703.0,318,1,99.5,5,1,1,7
1003,13704.0,8245,17956,309280.04000000004,2,5,5,12
1004,13705.0,5363,784,19932.08,3,2,3,8
1005,13706.0,6040,400,6615.8,3,2,2,7
1006,13707.0,14352,2304,38707.68,2,3,3,8
1007,13708.0,13279,2401,13981.169999999996,2,3,2,7
1008,13709.0,34755,112225,2113062.75,1,5,5,11
1009,13710.0,248,64,1443.84,5,1,1,7
1010,13711.0,2834,169,3276.78,4,1,1,6
1011,13712.0,2460,100,2288.4,4,1,1,6
1012,13715.0,35902,10816,112048.56000000001,1,4,4,9
1013,13716.0,5649,441,2903.88,3,2,1,6
1014,13717.0,16618,10404,147391.02000000002,2,4,4,10
1015,13718.0,3295,144,3678.6000000000004,4,1,1,6
1016,13719.0,5822,3600,62500.8,3,4,4,11
1017,13720.0,8680,1849,34395.7,2,3,3,8
1018,13721.0,1008,784,14675.920000000002,5,2,3,10
1019,13722.0,18081,7225,201909.84999999998,2,4,4,10
1020,13723.0,1302,36,1199.1,5,1,1,7
1021,13725.0,27114,10816,205978.24,1,4,4,9
1022,13726.0,3022,1764,45345.72,4,3,3,10
1023,13727.0,630,400,6669.6,5,2,2,9
1024,13728.0,10562,3969,64016.82,2,4,4,10
1025,13730.0,6377,1849,32361.8,3,3,3,9
1026,13731.0,8862,1444,23202.420000000002,2,3,3,8
1027,13732.0,924,1089,16231.380000000003,5,3,3,11
1028,13735.0,24855,38025,562290.2999999999,1,5,5,11
1029,13736.0,20330,36100,138662.0,1,5,4,10
1030,13737.0,6000,900,10188.0,3,3,2,8
1031,13739.0,54,9,650.7,5,1,1,7
1032,13740.0,5520,529,8067.25,3,2,2,7
1033,13741.0,4926,1156,22726.620000000003,3,3,3,9
1034,13742.0,71212,97969,972763.31,1,5,5,11
1035,13743.0,5642,1681,55005.6,3,3,4,10
1036,13744.0,14653,3969,68072.76,2,4,4,10
1037,13745.0,4050,625,7501.000000000001,3,2,2,7
1038,13747.0,373,1,79.6,5,1,1,7
1039,13748.0,4694,784,26551.0,3,2,3,8
1040,13750.0,4523,576,39534.24,3,2,3,8
1041,13751.0,2592,81,2666.25,4,1,1,6
1042,13752.0,15184,5625,88153.50000000001,2,4,4,10
1043,13753.0,10045,1225,25944.1,2,3,3,8
1044,13754.0,3140,144,3391.2000000000003,4,1,1,6
1045,13755.0,11238,103041,676687.26,2,5,5,12
1046,13756.0,18851,20164,736911.8400000001,2,5,5,12
1047,13758.0,25675,13689,373294.35000000003,1,4,5,10
1048,13759.0,1737,625,16485.25,4,2,3,9
1049,13760.0,8734,3249,16347.03,2,3,3,8
1050,13761.0,7628,4900,74945.5,3,4,4,11
1051,13762.0,1526,49,2147.04,4,1,1,6
1052,13763.0,945,225,25724.399999999998,5,2,3,10
1053,13764.0,37945,42849,314519.94,1,5,5,11
1054,13767.0,74597,135424,6337092.48,1,5,5,11
1055,13769.0,23644,18225,377528.85000000003,1,5,5,11
1056,13771.0,19418,14161,313499.55,1,4,5,10
1057,13772.0,17472,29929,194214.99000000002,2,5,4,11
1058,13774.0,1782,484,7590.0,4,2,2,8
1059,13777.0,36508,38809,5117500.5200000005,1,5,5,11
1060,13778.0,927,81,1608.3,5,1,1,7
1061,13780.0,1866,3249,20520.570000000003,4,3,3,10
1062,13781.0,4250,289,2173.28,3,2,1,6
1063,13782.0,18061,12769,102701.18000000001,2,4,4,10
1064,13784.0,6093,961,76346.48999999999,3,3,4,10
1065,13786.0,2569,49,1612.8,4,1,1,6
1066,13787.0,4348,961,9580.24,3,3,2,8
1067,13790.0,180,2025,15695.999999999998,5,3,3,11
1068,13791.0,1684,121,16676.0,4,1,3,8
1069,13792.0,1742,169,2542.1499999999996,4,1,1,6
1070,13798.0,68183,121801,12966693.65,1,5,5,11
1071,13799.0,7372,1521,26865.540000000005,3,3,3,9
1072,13800.0,10197,1089,18424.56,2,3,3,8
1073,13801.0,1518,529,7470.399999999999,4,2,2,8
1074,13802.0,14988,3600,275965.2,2,4,5,11
1075,13803.0,4335,289,4710.1900000000005,3,2,2,7
1076,13804.0,21227,18225,349432.64999999997,1,5,5,11
1077,13805.0,1138,169,12019.800000000001,5,1,2,8
1078,13806.0,630,100,2563.8,5,1,1,7
1079,13807.0,2569,49,788.1999999999999,4,1,1,6
1080,13808.0,5031,5776,132822.16000000003,3,4,4,11
1081,13809.0,3660,144,1860.6000000000001,3,1,1,5
1082,13810.0,1568,1225,52465.350000000006,4,3,4,11
1083,13811.0,2767,169,10588.5,4,1,2,7
1084,13812.0,2948,1296,19404.0,4,3,3,10
1085,13813.0,5583,4761,94313.34,3,4,4,11
1086,13814.0,6639,3249,90009.84,3,3,4,10
1087,13815.0,32046,30976,708815.36,1,5,5,11
1088,13816.0,1341,784,16006.760000000002,4,2,3,9
1089,13817.0,3594,576,9191.52,4,2,2,8
1090,13819.0,11158,1296,41052.6,2,3,3,8
1091,13821.0,13410,3481,22752.76,2,4,3,9
1092,13822.0,3665,9216,60672.0,3,4,4,11
1093,13823.0,2618,1600,38306.4,4,3,3,10
1094,13824.0,8657,2116,78151.24,2,3,4,9
1095,13826.0,1760,100,1895.0,4,1,1,6
1096,13827.0,10160,8464,37701.6,2,4,3,9
1097,13828.0,330,225,3142.3500000000004,5,2,1,8
1098,13831.0,12935,5184,158288.4,2,4,4,10
1099,13832.0,57,9,156.60000000000002,5,1,1,7
1100,13833.0,4452,784,10747.799999999997,3,2,2,7
1101,13835.0,7460,3025,45901.350000000006,3,3,3,9
1102,13837.0,4646,324,4798.620000000001,3,2,2,7
1103,13838.0,25941,27225,111345.3,1,5,4,10
1104,13841.0,252,1,85.0,5,1,1,7
1105,13842.0,39868,42436,697437.7200000001,1,5,5,11
1106,13844.0,220,400,7232.4,5,2,2,9
1107,13845.0,576,81,2816.82,5,1,1,7
1108,13846.0,13998,3025,47578.30000000001,2,3,3,8
1109,13848.0,1349,25,6275.0,4,1,2,7
1110,13849.0,9673,10201,155332.95,2,4,4,10
1111,13850.0,11997,8649,148379.64,2,4,4,10
1112,13851.0,12692,6561,214768.26,2,4,4,10
1113,13853.0,1311,529,25073.22,5,2,3,10
1114,13854.0,23497,12100,892047.2000000001,1,4,5,10
1115,13856.0,2642,196,5439.0,4,1,2,7
1116,13858.0,627,121,2377.87,5,1,1,7
1117,13859.0,9128,784,5632.48,2,2,2,6
1118,13860.0,3026,5776,94688.40000000001,4,4,4,12
1119,13862.0,25994,19321,307101.04000000004,1,5,5,11
1120,13863.0,4940,400,6115.599999999999,3,2,2,7
1121,13865.0,5105,900,15046.8,3,3,3,9
1122,13866.0,518,49,1019.6899999999999,5,1,1,7
1123,13867.0,4603,3600,60305.4,3,4,4,11
1124,13868.0,1223,1089,105353.81999999999,5,3,4,12
1125,13869.0,61068,92416,937429.6,1,5,5,11
1126,13870.0,18108,13225,318658.10000000003,2,4,5,11
1127,13871.0,49682,112896,2151492.0,1,5,5,11
1128,13873.0,4760,529,8960.800000000001,3,2,2,7
1129,13874.0,6444,324,9728.1,3,2,2,7
1130,13875.0,18634,10816,185826.16,2,4,4,10
1131,13876.0,441,49,858.9,5,1,1,7
1132,13877.0,258,9,351.71999999999997,5,1,1,7
1133,13878.0,1890,1225,44504.94999999999,4,3,3,10
1134,13880.0,24717,27225,531262.05,1,5,5,11
1135,13881.0,24666,31684,3054394.56,1,5,5,11
1136,13882.0,1967,4225,77423.45000000001,4,4,4,12
1137,13883.0,22582,20164,379776.16,1,5,5,11
1138,13884.0,6107,3481,46468.40000000001,3,4,3,10
1139,13885.0,5545,784,14190.4,3,2,2,7
1140,13886.0,1136,256,3896.96,5,2,2,9
1141,13887.0,3876,361,6641.449999999999,3,2,2,7
1142,13888.0,6522,1521,23231.129999999997,3,3,3,9
1143,13889.0,1380,225,6253.5,4,2,2,8
1144,13890.0,7584,12100,207219.10000000003,3,4,4,11
1145,13892.0,2212,729,17090.190000000002,4,2,3,9
1146,13893.0,6237,441,17243.100000000002,3,2,3,8
1147,13894.0,3491,729,15244.740000000003,4,2,3,9
1148,13895.0,10238,13924,305982.26,2,4,5,11
1149,13897.0,850,289,5289.72,5,2,2,9
1150,13898.0,3900,144,1871.16,3,1,1,5
1151,13899.0,4174,361,7381.879999999999,3,2,2,7
1152,13900.0,9367,1849,31860.85,2,3,3,8
1153,13901.0,25093,22201,427212.8,1,5,5,11
1154,13904.0,5331,676,8648.640000000001,3,2,2,7
1155,13908.0,19522,14884,289085.10000000003,1,5,5,11
1156,13911.0,33224,21904,381974.68,1,5,5,11
1157,13914.0,763,1089,20672.850000000002,5,3,3,11
1158,13917.0,1592,324,4896.72,4,2,2,8
1159,13918.0,3102,900,36385.20000000001,4,3,3,10
1160,13919.0,2644,784,10774.680000000002,4,2,2,8
1161,13922.0,2457,49,1205.7499999999998,4,1,1,6
1162,13923.0,1060,400,7022.600000000001,5,2,2,9
1163,13924.0,4319,13689,215145.44999999998,3,4,4,11
1164,13925.0,5054,1681,27808.25,3,3,3,9
1165,13926.0,253,121,2462.35,5,1,1,7
1166,13927.0,1554,441,7328.790000000002,4,2,2,8
1167,13928.0,1821,729,12543.39,4,2,2,8
1168,13929.0,1835,81,7583.849999999999,4,1,2,7
1169,13930.0,1759,289,5734.78,4,2,2,8
1170,13931.0,9210,3364,71776.74,2,4,4,10
1171,13932.0,4704,256,4918.4,3,2,2,7
1172,13933.0,3053,529,14002.169999999996,4,2,2,8
1173,13934.0,8153,961,28585.100000000002,2,3,3,8
1174,13936.0,4654,676,9791.079999999998,3,2,2,7
1175,13937.0,1521,81,1429.6499999999999,4,1,1,6
1176,13938.0,245,49,501.62,5,1,1,7
1177,13939.0,6361,2025,25584.749999999996,3,3,3,9
1178,13940.0,4584,2401,41117.86,3,3,3,9
1179,13941.0,8908,2025,230083.2,2,3,4,9
1180,13946.0,2231,121,6177.27,4,1,2,7
1181,13947.0,325,25,453.0,5,1,1,7
1182,13948.0,1080,9,306.0,5,1,1,7
1183,13949.0,7893,25600,388371.2,3,5,5,13
1184,13950.0,2630,1225,26077.100000000002,4,3,3,10
1185,13951.0,9480,1521,26303.549999999992,2,3,3,8
1186,13952.0,31682,18769,445396.727,1,5,5,11
1187,13953.0,2021,400,70313.59999999999,4,2,4,10
1188,13954.0,922,625,10998.0,5,2,2,9
1189,13955.0,6743,1089,10657.679999999998,3,3,2,8
1190,13956.0,22288,21609,149832.69,1,5,4,10
1191,13959.0,15274,8100,53463.6,2,4,4,10
1192,13960.0,452,144,2762.64,5,1,1,7
1193,13962.0,1799,121,1865.0500000000002,4,1,1,6
1194,13963.0,11668,1225,23258.9,2,3,3,8
1195,13967.0,290,4,161.4,5,1,1,7
1196,13969.0,76076,383161,5585961.23,1,5,5,11
1197,13971.0,22073,22201,410980.74000000005,1,5,5,11
1198,13972.0,2229,225,2853.7500000000005,4,2,1,7
1199,13973.0,3157,121,2911.7,4,1,1,6
1200,13974.0,1372,784,11580.519999999999,4,2,2,8
1201,13975.0,48392,108241,809747.96,1,5,5,11
1202,13976.0,2060,100,3579.8,4,1,1,6
1203,13978.0,644,225,2951.85,5,2,1,8
1204,13979.0,3942,2916,46972.97999999999,3,3,3,9
1205,13980.0,660,121,2201.54,5,1,1,7
1206,13982.0,22754,12321,207770.91,1,4,4,9
1207,13983.0,24898,11449,278567.01,1,4,5,10
1208,13984.0,3735,256,14728.16,3,2,3,8
1209,13985.0,33154,123201,2478105.63,1,5,5,11
1210,13986.0,221,169,4165.9800000000005,5,1,2,8
1211,13988.0,29848,54756,970622.64,1,5,5,11
1212,13989.0,6667,1681,51909.28,3,3,4,10
1213,13990.0,3408,256,4980.8,4,2,2,8
1214,13991.0,4255,6724,69936.16,3,4,4,11
1215,13992.0,150,25,384.0,5,1,1,7
1216,13993.0,23848,14641,419429.56000000006,1,5,5,11
1217,13994.0,10411,21904,336572.72000000003,2,5,5,12
1218,13995.0,10407,7396,119857.34000000001,2,4,4,10
1219,13999.0,32936,43264,811576.48,1,5,5,11
1220,14000.0,3165,225,9534.900000000001,4,2,2,8
1221,14001.0,7512,1521,79680.12,3,3,4,10
1222,14002.0,6606,2209,24897.309999999994,3,3,3,9
1223,14004.0,23052,29241,783631.44,1,5,5,11
1224,14005.0,8008,7056,241476.47999999998,2,4,5,11
1225,14006.0,6467,900,28865.7,3,3,3,9
1226,14009.0,8484,1764,29215.619999999995,2,3,3,8
1227,14012.0,3047,121,3616.8,4,1,1,6
1228,14013.0,5445,1156,16082.68,3,3,3,9
1229,14014.0,3003,1521,19702.02,4,3,3,10
1230,14015.0,1040,400,18346.8,5,2,3,10
1231,14016.0,39897,25921,698934.81,1,5,5,11
1232,14019.0,6220,4356,93826.26,3,4,4,11
1233,14020.0,1920,1521,25069.200000000004,4,3,3,10
1234,14021.0,4553,484,13901.800000000003,3,2,2,7
1235,14022.0,6300,784,12320.0,3,2,2,7
1236,14023.0,4105,961,18106.17,3,3,3,9
1237,14024.0,1975,256,5243.200000000001,4,2,2,8
1238,14027.0,360,36,628.9200000000001,5,1,1,7
1239,14029.0,1431,225,7014.900000000001,4,2,2,8
1240,14030.0,44548,58564,570839.28,1,5,5,11
1241,14031.0,45982,62500,4321715.0,1,5,5,11
1242,14032.0,27943,20449,425509.37,1,5,5,11
1243,14034.0,5267,7396,55804.54000000001,3,4,4,11
1244,14035.0,8444,4356,94249.32,2,4,4,10
1245,14036.0,10792,1444,23812.7,2,3,3,8
1246,14037.0,9816,784,4121.599999999999,2,2,2,6
1247,14038.0,14301,8464,143554.95999999993,2,4,4,10
1248,14039.0,198,36,913.1999999999999,5,1,1,7
1249,14040.0,42136,52441,815313.28,1,5,5,11
1250,14041.0,5586,441,2969.61,3,2,1,6
1251,14044.0,32888,42436,133162.52000000002,1,5,4,10
1252,14045.0,1830,36,9958.5,4,1,2,7
1253,14046.0,3976,196,2169.86,3,1,1,5
1254,14047.0,6102,1024,41875.52,3,3,3,9
1255,14048.0,25925,7225,34844.05,1,4,3,8
1256,14049.0,69667,228484,2666628.16,1,5,5,11
1257,14050.0,4449,2916,40303.439999999995,3,3,3,9
1258,14051.0,35021,44100,3278181.900000001,1,5,5,11
1259,14052.0,1064,3136,12620.16,5,3,2,10
1260,14053.0,601,16,1041.0,5,1,1,7
1261,14054.0,390,36,554.76,5,1,1,7
1262,14055.0,1060,100,7256.4000000000015,5,1,2,8
1263,14056.0,166034,1183744,8870148.48,1,5,5,11
1264,14057.0,60612,80089,1757899.78,1,5,5,11
1265,14059.0,2128,64,1468.8,4,1,1,6
1266,14060.0,36722,40804,1240364.84,1,5,5,11
1267,14062.0,24990,12321,1161598.3500000003,1,4,5,10
1268,14064.0,11501,5929,102744.17999999998,2,4,4,10
1269,14066.0,1862,49,1067.8500000000001,4,1,1,6
1270,14067.0,4101,2704,19484.399999999998,3,3,3,9
1271,14068.0,7680,576,6380.400000000001,3,2,2,7
1272,14071.0,14881,104329,464335.11000000004,2,5,5,12
1273,14073.0,416,169,1963.52,5,1,1,7
1274,14075.0,5053,1849,40517.18,3,3,3,9
1275,14076.0,5676,1936,5221.4800000000005,3,3,2,8
1276,14077.0,8834,1764,20975.640000000003,2,3,3,8
1277,14078.0,14719,4225,68209.04999999999,2,4,4,10
1278,14079.0,1488,144,4501.199999999999,4,1,2,7
1279,14080.0,128,16,182.4,5,1,1,7
1280,14081.0,49923,22500,138243.0,1,5,4,10
1281,14082.0,10556,841,5285.25,2,2,2,6
1282,14083.0,34801,31329,177513.3,1,5,4,10
1283,14085.0,95389,200704,1980737.9200000004,1,5,5,11
1284,14087.0,136,4624,13019.96,5,4,2,11
1285,14088.0,71670,346921,29739676.09,1,5,5,11
1286,14089.0,728,169,2063.75,5,1,1,7
1287,14090.0,324,1,76.32000000000001,5,1,1,7
1288,14092.0,39563,45796,872458.74,1,5,5,11
1289,14093.0,1200,10000,43386.0,5,4,3,12
1290,14096.0,202575,26122321,333057241.69,1,5,5,11
1291,14098.0,756,441,3094.3499999999995,5,2,1,8
1292,14099.0,50450,62500,776042.5,1,5,5,11
1293,14100.0,3425,625,4798.75,4,2,2,8
1294,14101.0,7819,1225,209187.65000000002,3,3,4,10
1295,14102.0,1773,3364,64141.04000000001,4,4,4,12
1296,14104.0,3443,441,4540.41,4,2,2,8
1297,14105.0,17686,5476,93701.02,2,4,4,10
1298,14107.0,26352,15129,332497.29,1,5,5,11
1299,14108.0,2156,1156,20328.940000000002,4,3,3,10
1300,14109.0,648,81,1297.8,5,1,1,7
1301,14110.0,24061,24336,886571.4000000003,1,5,5,11
1302,14111.0,848,100,6928.5,5,1,2,8
1303,14112.0,24255,25600,466424.0,1,5,5,11
1304,14113.0,1595,1156,62574.28,4,3,4,11
1305,14114.0,4722,225,5797.95,3,2,2,7
1306,14116.0,5269,5184,99557.27999999998,3,4,4,11
1307,14117.0,429,9,270.0,5,1,1,7
1308,14121.0,3589,25281,442043.85000000003,4,5,5,14
1309,14124.0,420,25,2097.9,5,1,1,7
1310,14125.0,8434,27556,451624.58,2,5,5,12
1311,14126.0,147,225,10591.95,5,2,2,9
1312,14127.0,10334,1936,31227.239999999998,2,3,3,8
1313,14128.0,7050,2116,29325.00000000001,3,3,3,9
1314,14129.0,6048,2704,58440.719999999994,3,3,4,10
1315,14130.0,21054,4356,31740.060000000005,1,4,3,8
1316,14132.0,17327,40000,717206.0,2,5,5,12
1317,14133.0,6588,784,16957.92,3,2,3,8
1318,14135.0,31299,17956,628501.54,1,5,5,11
1319,14138.0,2030,2116,44430.48000000001,4,3,3,10
1320,14139.0,1196,676,10811.32,5,2,2,9
1321,14140.0,1318,4356,61713.299999999996,5,4,4,13
1322,14141.0,2624,1600,36605.2,4,3,3,10
1323,14142.0,8206,484,6859.82,2,2,2,6
1324,14143.0,931,49,810.6,5,1,1,7
1325,14145.0,1636,121,41164.2,4,1,3,8
1326,14146.0,26531,44100,880110.0,1,5,5,11
1327,14147.0,804,25,2417.0,5,1,1,7
1328,14148.0,699,9,471.59999999999997,5,1,1,7
1329,14149.0,6160,784,12505.360000000002,3,2,2,7
1330,14150.0,4798,676,17124.64,3,2,3,8
1331,14152.0,8286,2401,30443.21,2,3,3,8
1332,14154.0,12428,2704,69972.23999999999,2,3,4,9
1333,14155.0,1596,36,712.5,4,1,1,6
1334,14156.0,242627,1946025,163508061.6,1,5,5,11
1335,14157.0,10716,2116,19544.94,2,3,3,8
1336,14158.0,1640,1681,20814.06,4,3,3,10
1337,14159.0,144908,1380625,5440661.25,1,5,5,11
1338,14161.0,27939,10816,114152.47999999998,1,4,4,9
1339,14162.0,5872,625,7234.0,3,2,2,7
1340,14163.0,9109,2704,127187.32000000002,2,3,4,9
1341,14164.0,2310,841,47321.330000000016,4,2,3,9
1342,14165.0,6600,576,2890.56,3,2,1,6
1343,14167.0,10734,2500,28129.5,2,3,3,8
1344,14171.0,5684,3364,21099.82,3,4,3,10
1345,14173.0,3009,841,13074.360000000002,4,2,2,8
1346,14174.0,858,676,3495.96,5,2,1,8
1347,14175.0,17927,22201,480122.7,2,5,5,12
1348,14176.0,9953,961,17883.899999999998,2,3,3,8
1349,14177.0,5464,1681,22527.86,3,3,3,9
1350,14178.0,21418,101124,508882.68000000005,1,5,5,11
1351,14179.0,7708,24649,110146.48999999999,3,5,4,12
1352,14180.0,58852,57600,1139644.8,1,5,5,11
1353,14184.0,1584,576,10869.36,4,2,2,8
1354,14185.0,993,9,592.95,5,1,1,7
1355,14188.0,9901,4225,133533.4,2,4,4,10
1356,14189.0,42888,70225,1233331.2,1,5,5,11
1357,14191.0,21422,67081,1213352.84,1,5,5,11
1358,14193.0,7460,1764,35842.380000000005,3,3,3,9
1359,14194.0,73377,335241,6571372.08,1,5,5,11
1360,14195.0,1662,49,7083.999999999998,4,1,2,7
1361,14196.0,636,36,2013.12,5,1,1,7
1362,14198.0,5041,1521,27354.6,3,3,3,9
1363,14199.0,436,4,370.8,5,1,1,7
1364,14201.0,6418,1369,27655.280000000006,3,3,3,9
1365,14204.0,78,1521,5873.789999999998,5,3,2,10
1366,14205.0,3856,576,11200.800000000003,3,2,2,7
1367,14206.0,4780,400,6563.200000000001,3,2,2,7
1368,14208.0,940,100,1517.3999999999999,5,1,1,7
1369,14209.0,17800,7569,180388.41000000003,2,4,4,10
1370,14210.0,26420,10404,194395.68,1,4,4,9
1371,14211.0,16704,12544,251003.20000000004,2,4,5,11
1372,14212.0,801,81,9634.32,5,1,2,8
1373,14214.0,14239,4489,67293.46,2,4,4,10
1374,14215.0,20678,11664,193289.76,1,4,4,9
1375,14216.0,1392,3481,108518.7,4,4,4,12
1376,14217.0,16471,10000,200498.0,2,4,4,10
1377,14218.0,504,144,2033.7600000000002,5,1,1,7
1378,14219.0,28,49,629.5799999999999,5,1,1,7
1379,14220.0,6408,441,13280.399999999998,3,2,2,7
1380,14221.0,29276,37249,662530.4,1,5,5,11
1381,14222.0,7257,1681,28009.97,3,3,3,9
1382,14223.0,9981,3600,59467.8,2,4,4,10
1383,14224.0,25590,12769,114099.49,1,4,4,9
1384,14226.0,11183,4356,146176.13999999996,2,4,4,10
1385,14227.0,34212,30625,586418.0,1,5,5,11
1386,14229.0,9120,1600,61888.0,2,3,4,9
1387,14231.0,12076,2500,46285.5,2,3,3,8
1388,14232.0,19822,13225,235528.05000000002,1,4,5,10
1389,14233.0,6482,1225,51195.20000000002,3,3,3,9
1390,14234.0,7657,21609,110855.64000000001,3,5,4,12
1391,14235.0,16092,6241,248443.94,2,4,5,11
1392,14236.0,2076,225,7362.900000000001,4,2,2,8
1393,14237.0,3357,81,1449.0000000000002,4,1,1,6
1394,14238.0,2608,64,1174.8,4,1,1,6
1395,14239.0,21441,12544,266655.20000000007,1,4,5,10
1396,14240.0,3210,1764,37394.280000000006,4,3,3,10
1397,14241.0,1830,100,2137.0000000000005,4,1,1,6
1398,14242.0,4472,256,4488.8,3,2,2,7
1399,14243.0,31276,19881,365016.56999999995,1,5,5,11
1400,14245.0,26600,11664,182892.59999999998,1,4,4,9
1401,14246.0,12192,5625,110554.50000000001,2,4,4,10
1402,14247.0,5560,400,2735.3999999999996,3,2,1,6
1403,14248.0,2544,64,2420.64,4,1,1,6
1404,14250.0,6845,12321,211349.55,3,4,4,11
1405,14251.0,2495,6084,224616.59999999998,4,4,4,12
1406,14256.0,17108,2809,51360.18,2,3,4,9
1407,14257.0,21578,11236,328570.32,1,4,5,10
1408,14258.0,23684,12321,1406367.78,1,4,5,10
1409,14259.0,705,25,600.0,5,1,1,7
1410,14261.0,3860,2704,60499.4,3,3,4,10
1411,14262.0,12284,20449,374406.89,2,5,5,12
1412,14264.0,3073,289,5677.490000000001,4,2,2,8
1413,14265.0,3964,961,16435.579999999998,3,3,3,9
1414,14267.0,11850,3025,83393.2,2,3,4,9
1415,14270.0,9599,841,14286.849999999999,2,2,2,6
1416,14271.0,2250,100,1123.1999999999998,4,1,1,6
1417,14272.0,3857,1089,14452.679999999998,3,3,2,8
1418,14273.0,4556,841,16239.130000000001,3,2,3,8
1419,14276.0,11869,4096,71663.36000000002,2,4,4,10
1420,14277.0,18052,49284,929736.0,2,5,5,12
1421,14280.0,1568,64,1072.32,4,1,1,6
1422,14282.0,22948,23716,570021.7600000001,1,5,5,11
1423,14284.0,1688,1024,19048.0,4,3,3,10
1424,14285.0,1666,729,51570.27,4,2,4,10
1425,14286.0,38353,78400,1296050.0,1,5,5,11
1426,14287.0,832,81,1589.67,5,1,1,7
1427,14288.0,3408,256,6825.6,4,2,2,8
1428,14289.0,10134,2209,42829.22,2,3,3,8
1429,14290.0,12739,10201,233779.65000000002,2,4,5,11
1430,14291.0,33695,56169,920330.25,1,5,5,11
1431,14292.0,15090,10000,487192.99999999994,2,4,5,11
1432,14293.0,10364,3721,63840.159999999996,2,4,4,10
1433,14295.0,200,25,831.0,5,1,1,7
1434,14297.0,4947,3844,80930.45999999998,3,4,4,11
1435,14298.0,305695,2679769,84350190.10000001,1,5,5,11
1436,14299.0,16594,20449,567083.66,2,5,5,12
1437,14300.0,54,9,129.60000000000002,5,1,1,7
1438,14301.0,1521,169,8321.820000000002,4,1,2,7
1439,14304.0,3774,289,6518.6500000000015,3,2,2,7
1440,14305.0,11465,11025,195190.80000000005,2,4,4,10
1441,14306.0,2567,1089,69079.56000000001,4,3,4,11
1442,14307.0,42206,32400,539229.6,1,5,5,11
1443,14309.0,18530,13689,275246.01,2,4,5,11
1444,14311.0,4840,400,6205.2,3,2,2,7
1445,14312.0,15394,7569,140208.33,2,4,4,10
1446,14314.0,848,64,960.0,5,1,1,7
1447,14315.0,14913,10201,250594.13,2,4,5,11
1448,14317.0,1536,576,12205.92,4,2,2,8
1449,14320.0,9284,961,14811.49,2,3,3,8
1450,14321.0,19169,15129,188282.25000000003,1,5,4,10
1451,14323.0,6460,1296,21782.160000000003,3,3,3,9
1452,14326.0,1936,64,1470.8,4,1,1,6
1453,14327.0,1956,144,3739.8,4,1,1,6
1454,14329.0,49743,66564,1283611.92,1,5,5,11
1455,14331.0,3736,784,12954.480000000001,3,2,2,7
1456,14332.0,1372,625,21005.25,4,2,3,9
1457,14333.0,1005,225,6228.0,5,2,2,9
1458,14334.0,34142,26244,413458.0200000001,1,5,5,11
1459,14335.0,4160,3600,27291.600000000002,3,4,3,10
1460,14336.0,14734,8100,145341.9,2,4,4,10
1461,14338.0,6041,961,18234.819999999996,3,3,3,9
1462,14339.0,3388,196,4333.28,4,1,2,7
1463,14340.0,1308,36,808.1999999999999,5,1,1,7
1464,14341.0,17567,16384,277373.44,2,5,5,12
1465,14342.0,2278,441,14039.760000000004,4,2,2,8
1466,14344.0,16656,5041,63185.03000000001,2,4,4,10
1467,14345.0,228,36,653.88,5,1,1,7
1468,14346.0,10209,3600,61294.8,2,4,4,10
1469,14348.0,4680,324,7372.26,3,2,2,7
1470,14349.0,310,961,4138.5,5,3,2,10
1471,14350.0,4932,324,5092.739999999999,3,2,2,7
1472,14351.0,164,1,51.0,5,1,1,7
1473,14352.0,10656,2209,50711.120000000024,2,3,3,8
1474,14353.0,1290,36,543.5999999999999,5,1,1,7
1475,14354.0,195,81,1472.58,5,1,1,7
1476,14355.0,4015,121,1918.4,3,1,1,5
1477,14356.0,2647,1089,23140.59,4,3,3,10
1478,14357.0,1720,1600,9004.8,4,3,2,9
1479,14359.0,3386,3025,50169.899999999994,4,3,3,10
1480,14360.0,9180,13689,247809.51,2,4,5,11
1481,14362.0,814,1369,5605.500000000001,5,3,2,10
1482,14364.0,11459,4761,256497.15,2,4,5,11
1483,14367.0,81642,271441,4807694.22,1,5,5,11
1484,14368.0,2552,64,1240.0,4,1,1,6
1485,14371.0,1180,16,402.0,5,1,1,7
1486,14373.0,1432,16,306.2,4,1,1,6
1487,14375.0,12210,4356,15546.960000000001,2,4,3,9
1488,14377.0,2385,121,6787.549999999999,4,1,2,7
1489,14379.0,6291,2116,16012.6,3,3,3,9
1490,14381.0,2912,3136,11350.08,4,3,2,9
1491,14382.0,3276,15876,77551.73999999999,4,5,4,13
1492,14383.0,4819,3481,73613.71,3,4,4,11
1493,14385.0,217,196,2829.54,5,1,1,7
1494,14386.0,2072,49,996.8000000000001,4,1,1,6
1495,14387.0,9292,19321,240136.4,2,5,5,12
1496,14388.0,28104,34596,597588.24,1,5,5,11
1497,14389.0,5300,2025,46955.700000000004,3,3,3,9
1498,14390.0,38093,80656,1318489.88,1,5,5,11
1499,14393.0,1090,25,339.74999999999994,5,1,1,7
1500,14395.0,57540,121104,1211008.68,1,5,5,11
1501,14396.0,15149,5329,35623.270000000004,2,4,3,9
1502,14397.0,7877,7569,227327.52,3,4,4,11
1503,14400.0,3725,625,14367.499999999998,3,2,2,7
1504,14401.0,23687,33124,737369.36,1,5,5,11
1505,14403.0,4521,400,29516.200000000004,3,2,3,8
1506,14404.0,22562,10000,144932.00000000003,1,4,4,9
1507,14406.0,952,64,1254.0,5,1,1,7
1508,14407.0,13648,5329,157514.29,2,4,4,10
1509,14408.0,16446,11236,275497.18,2,4,5,11
1510,14409.0,9503,2916,111210.30000000002,2,3,4,9
1511,14410.0,36508,36100,209051.30000000005,1,5,4,10
1512,14411.0,4340,196,14882.0,3,1,3,7
1513,14412.0,2646,1849,33111.29,4,3,3,10
1514,14413.0,7964,484,2663.1,2,2,1,5
1515,14414.0,13319,9409,145207.06,2,4,4,10
1516,14415.0,92968,335241,3390375.03,1,5,5,11
1517,14416.0,528,196,6863.080000000001,5,1,2,8
1518,14418.0,3335,15376,240219.0,4,5,5,14
1519,14419.0,22914,40804,212461.58,1,5,4,10
1520,14420.0,2871,841,11238.08,4,2,2,8
1521,14421.0,3849,729,21953.970000000005,3,2,3,8
1522,14422.0,20462,49284,946528.0799999998,1,5,5,11
1523,14423.0,654,9,795.5999999999999,5,1,1,7
1524,14424.0,17,1,322.08,5,1,1,7
1525,14426.0,42104,50176,1003894.0800000001,1,5,5,11
1526,14427.0,1058,289,6176.78,5,2,2,9
1527,14428.0,12862,18769,167696.22000000003,2,5,4,11
1528,14431.0,5134,289,7996.12,3,2,2,7
1529,14432.0,18499,142129,847684.5,2,5,5,12
1530,14434.0,596,144,16473.6,5,1,3,9
1531,14436.0,882,81,801.54,5,1,1,7
1532,14437.0,1825,25,315.0,4,1,1,6
1533,14438.0,2754,81,1187.1000000000001,4,1,1,6
1534,14439.0,10208,1024,85159.68,2,3,4,9
1535,14440.0,11465,3025,129672.40000000002,2,3,4,9
1536,14441.0,5072,2601,87357.39000000001,3,3,4,10
1537,14442.0,16212,3969,100158.65999999999,2,4,4,10
1538,14443.0,18322,8649,132078.6,2,4,4,10
1539,14446.0,28782,76729,279866.95,1,5,5,11
1540,14447.0,10006,4900,81426.10000000002,2,4,4,10
1541,14448.0,6570,400,7507.0,3,2,2,7
1542,14449.0,39294,62500,221450.00000000003,1,5,4,10
1543,14450.0,9496,1600,19330.0,2,3,3,8
1544,14451.0,13268,11025,67609.50000000001,2,4,4,10
1545,14452.0,3090,3600,15543.0,4,4,3,11
1546,14453.0,4180,484,2638.46,3,2,1,6
1547,14456.0,67472,896809,2857364.16,1,5,5,11
1548,14457.0,1240,16,454.56,5,1,1,7
1549,14459.0,5735,1369,68003.04000000001,3,3,4,10
1550,14460.0,2509,256,6949.44,4,2,2,8
1551,14461.0,36932,32400,378550.79999999993,1,5,5,11
1552,14462.0,46405,54289,461472.81,1,5,5,11
1553,14463.0,946,36,3177.7200000000003,5,1,1,7
1554,14465.0,30650,15129,127728.12000000001,1,5,4,10
1555,14466.0,12617,5184,163612.80000000002,2,4,4,10
1556,14467.0,6895,7921,53067.14000000001,3,4,4,11
1557,14470.0,10133,1849,19831.170000000002,2,3,3,8
1558,14472.0,66432,70225,490957.55000000005,1,5,5,11
1559,14473.0,726,49,1640.38,5,1,1,7
1560,14474.0,1334,841,15882.140000000003,4,2,3,9
1561,14475.0,8090,1764,38885.700000000004,2,3,3,8
1562,14476.0,4369,289,3281.0,3,2,1,6
1563,14477.0,922,100,13096.0,5,1,2,8
1564,14479.0,5674,324,5692.499999999999,3,2,2,7
1565,14480.0,143,169,3627.65,5,1,1,7
1566,14481.0,6396,900,19095.3,3,3,3,9
1567,14482.0,8175,18769,277124.97,2,5,5,12
1568,14483.0,2529,81,1233.8999999999999,4,1,1,6
1569,14484.0,700,196,4506.88,5,1,2,8
1570,14485.0,1748,2116,7488.8,4,3,2,9
1571,14487.0,13021,19600,163167.2,2,5,4,11
1572,14488.0,3082,2116,48956.88000000001,4,3,3,10
1573,14489.0,6210,900,13901.4,3,3,2,8
1574,14491.0,3763,289,5795.81,3,2,2,7
1575,14493.0,6630,14400,285988.8,3,4,5,12
1576,14494.0,175,49,976.9200000000001,5,1,1,7
1577,14495.0,442,36,742.8,5,1,1,7
1578,14496.0,6219,361,10237.390000000001,3,2,2,7
1579,14497.0,8961,841,13785.73,2,2,2,6
1580,14498.0,22840,37249,377762.76,1,5,5,11
1581,14499.0,20232,36100,153603.6,1,5,4,10
1582,14500.0,1145,49,2497.9500000000003,5,1,1,7
1583,14501.0,2374,100,2512.1,4,1,1,6
1584,14502.0,84997,369664,1477336.64,1,5,5,11
1585,14503.0,11198,26896,581094.64,2,5,5,12
1586,14504.0,25317,11449,72038.81999999999,1,4,4,9
1587,14505.0,135717,616225,4599652.55,1,5,5,11
1588,14506.0,39555,87025,578391.75,1,5,5,11
1589,14507.0,17373,9025,129948.59999999996,2,4,4,10
1590,14508.0,2818,3025,14742.750000000004,4,3,3,10
1591,14511.0,3528,4624,89407.08000000002,4,4,4,12
1592,14512.0,4931,529,6331.44,3,2,2,7
1593,14513.0,2940,144,5467.08,4,1,2,7
1594,14514.0,13049,4761,68323.8,2,4,4,10
1595,14515.0,9006,9604,203535.22000000003,2,4,4,10
1596,14517.0,2106,324,5948.1,4,2,2,8
1597,14518.0,1024,256,2789.92,5,2,1,8
1598,14520.0,293,16,1082.4,5,1,1,7
1599,14522.0,2217,289,16567.18,4,2,3,9
1600,14523.0,1296,144,2893.08,5,1,1,7
1601,14524.0,39863,38809,363234.51,1,5,5,11
1602,14525.0,40080,79524,1188883.8,1,5,5,11
1603,14527.0,165872,942841,8260423.230000001,1,5,5,11
1604,14528.0,666,324,6555.960000000001,5,2,2,9
1605,14529.0,16555,45369,123243.92999999998,2,5,4,11
1606,14530.0,36104,45369,609629.43,1,5,5,11
1607,14532.0,18450,4096,59702.4,2,4,4,10
1608,14533.0,7752,3844,120882.64000000003,3,4,4,11
1609,14534.0,85371,258064,2233828.4,1,5,5,11
1610,14535.0,43851,107584,936387.52,1,5,5,11
1611,14536.0,4662,324,3077.1,3,2,1,6
1612,14537.0,570,100,3555.6000000000004,5,1,1,7
1613,14538.0,1792,361,7376.75,4,2,2,8
1614,14539.0,683,1024,17199.36,5,3,3,11
1615,14540.0,6909,5041,67638.86,3,4,4,11
1616,14541.0,30320,11025,152601.75,1,4,4,9
1617,14542.0,925,25,516.25,5,1,1,7
1618,14543.0,15246,5041,255580.83,2,4,5,11
1619,14544.0,20862,12321,222477.30000000005,1,4,4,9
1620,14546.0,45468,157609,1021850.2100000001,1,5,5,11
1621,14547.0,10038,126025,1411036.2500000002,2,5,5,12
1622,14548.0,934,16,2611.2,5,1,1,7
1623,14549.0,17416,3136,16197.44,2,3,3,8
1624,14550.0,1354,2209,35596.39000000001,4,3,3,10
1625,14551.0,1482,100,1862.3,4,1,1,6
1626,14552.0,8607,3249,9360.539999999999,2,3,2,7
1627,14553.0,13251,12769,97097.51000000001,2,4,4,10
1628,14554.0,5686,41209,462736.47,3,5,5,13
1629,14555.0,4513,361,5938.26,3,2,2,7
1630,14557.0,1360,256,12614.08,4,2,2,8
1631,14560.0,13768,5476,165594.97999999995,2,4,4,10
1632,14561.0,8659,4761,74572.44,2,4,4,10
1633,14562.0,47451,175561,2097836.6300000004,1,5,5,11
1634,14565.0,29627,16129,393588.24000000005,1,5,5,11
1635,14566.0,440,16,5728.0,5,1,2,8
1636,14567.0,2810,1089,50501.88,4,3,3,10
1637,14569.0,12,144,2728.68,5,1,1,7
1638,14570.0,8120,841,6323.74,2,2,2,6
1639,14572.0,45585,68644,734789.48,1,5,5,11
1640,14573.0,62321,51529,372239.14,1,5,5,11
1641,14576.0,372,1,35.400000000000006,5,1,1,7
1642,14577.0,24284,15129,105744.33000000002,1,5,4,10
1643,14578.0,72,576,4047.12,5,2,2,9
1644,14581.0,272,289,2356.2,5,2,1,8
1645,14582.0,240,36,684.66,5,1,1,7
1646,14583.0,37269,91204,298061.92,1,5,5,11
1647,14584.0,18495,9604,101239.88000000002,2,4,4,10
1648,14585.0,1450,841,4554.450000000001,4,2,2,8
1649,14586.0,5244,361,4509.84,3,2,2,7
1650,14587.0,95143,137641,586287.59,1,5,5,11
1651,14589.0,1113,9,119.25,5,1,1,7
1652,14591.0,9966,30976,232356.96000000002,2,5,4,11
1653,14592.0,8621,24964,88154.51999999999,2,5,4,11
1654,14593.0,14499,22801,93189.65,2,5,4,11
1655,14594.0,11710,2704,18893.159999999996,2,3,3,8
1656,14595.0,6836,10404,177541.19999999998,3,4,4,11
1657,14597.0,1057,2209,40713.280000000006,5,3,3,11
1658,14598.0,2200,2500,11098.5,4,3,2,9
1659,14600.0,7625,625,9833.25,3,2,2,7
1660,14601.0,70,49,1497.7200000000003,5,1,1,7
1661,14603.0,548,4,1320.0,5,1,1,7
1662,14606.0,508389,7166329,32327853.55,1,5,5,11
1663,14607.0,3800,6561,1312969.5,3,4,5,12
1664,14608.0,1155,400,35703.0,5,2,3,10
1665,14609.0,688,16,2406.2400000000002,5,1,1,7
1666,14616.0,843,9,1218.24,5,1,1,7
1667,14618.0,1792,256,8855.04,4,2,2,8
1668,14619.0,4900,400,7888.8,3,2,2,7
1669,14620.0,6500,676,10732.279999999999,3,2,2,7
1670,14621.0,11977,8464,164529.12000000002,2,4,4,10
1671,14622.0,3864,441,6732.179999999999,3,2,2,7
1672,14623.0,19820,17689,117931.1,1,5,4,10
1673,14624.0,765,169,2936.0499999999997,5,1,1,7
1674,14625.0,15998,2809,47680.39,2,3,3,8
1675,14626.0,13922,14884,340534.94,2,5,5,12
1676,14628.0,3996,576,16127.039999999997,3,2,3,8
1677,14629.0,4169,22500,143289.0,3,5,4,12
1678,14631.0,7431,1681,41286.18,3,3,3,9
1679,14632.0,2096,64,916.48,4,1,1,6
1680,14633.0,5320,400,6898.000000000002,3,2,2,7
1681,14636.0,4720,784,17075.800000000003,3,2,3,8
1682,14638.0,800,256,7097.6,5,2,2,9
1683,14639.0,31604,29584,513332.27999999997,1,5,5,11
1684,14640.0,13809,11025,221274.90000000002,2,4,4,10
1685,14641.0,147,49,773.2199999999999,5,1,1,7
1686,14642.0,116,4,192.24,5,1,1,7
1687,14643.0,8090,961,21508.109999999997,2,3,3,8
1688,14644.0,3590,676,21599.76,4,2,3,9
1689,14645.0,5751,900,17912.699999999997,3,3,3,9
1690,14646.0,336110,4326400,582828521.6,1,5,5,11
1691,14647.0,5628,784,6609.12,3,2,2,7
1692,14649.0,14536,34596,260881.74,2,5,5,12
1693,14651.0,15263,10201,66028.74999999997,2,4,4,10
1694,14652.0,2233,841,3311.2200000000003,4,2,1,7
1695,14653.0,16632,54756,450836.10000000003,2,5,5,12
1696,14655.0,4362,2401,94679.27,3,3,4,10
1697,14656.0,16826,6400,23284.0,2,4,3,9
1698,14657.0,27356,15876,106875.72,1,5,4,10
1699,14658.0,1713,841,7167.35,4,2,2,8
1700,14659.0,42963,64009,640072.2899999999,1,5,5,11
1701,14660.0,2776,900,8572.199999999999,4,3,2,9
1702,14661.0,104,16,431.8,5,1,1,7
1703,14662.0,25926,24649,116395.08999999998,1,5,4,10
1704,14664.0,2772,9604,62351.520000000004,4,4,4,12
1705,14665.0,16136,8100,165213.0,2,4,4,10
1706,14666.0,336,196,2733.5,5,1,1,7
1707,14667.0,110386,321489,5202247.680000001,1,5,5,11
1708,14669.0,49925,27556,209033.84000000003,1,5,4,10
1709,14670.0,34440,15129,48321.78,1,5,3,9
1710,14672.0,17742,3721,46698.549999999996,2,4,3,9
1711,14673.0,6646,5476,128493.6,3,4,4,11
1712,14675.0,1552,9409,57846.92,4,4,4,12
1713,14676.0,6838,1764,107026.07999999999,3,3,4,10
1714,14680.0,57435,66564,7418560.38,1,5,5,11
1715,14681.0,1197,49,3492.65,5,1,1,7
1716,14682.0,388,4,104.0,5,1,1,7
1717,14684.0,51394,152100,468588.8999999999,1,5,5,11
1718,14687.0,1590,225,9425.699999999999,4,2,2,8
1719,14688.0,62395,104976,1807628.4000000001,1,5,5,11
1720,14689.0,2704,169,1466.3999999999999,4,1,1,6
1721,14690.0,5108,2304,17042.4,3,3,3,9
1722,14691.0,7794,5041,150117.43,3,4,4,11
1723,14692.0,17725,4624,40225.4,2,4,3,9
1724,14693.0,2112,64,1383.2,4,1,1,6
1725,14696.0,23257,16900,270263.5,1,5,5,11
1726,14697.0,4796,484,4149.42,3,2,2,7
1727,14698.0,5758,40000,243454.0,3,5,5,13
1728,14699.0,1712,64,873.04,4,1,1,6
1729,14700.0,17476,12544,245851.19999999995,2,4,5,11
1730,14701.0,64807,106929,826031.43,1,5,5,11
1731,14702.0,52105,116964,1112112.18,1,5,5,11
1732,14703.0,308,484,6999.740000000001,5,2,2,9
1733,14704.0,24452,154449,587126.28,1,5,5,11
1734,14705.0,198,1,179.0,5,1,1,7
1735,14708.0,4752,784,31538.359999999997,3,2,3,8
1736,14709.0,33514,38416,964523.8400000002,1,5,5,11
1737,14710.0,4394,18496,81529.28,3,5,4,12
1738,14711.0,53336,119025,979668.8999999999,1,5,5,11
1739,14712.0,1904,625,22926.75,4,2,3,9
1740,14713.0,64284,114244,899823.6000000001,1,5,5,11
1741,14714.0,240,100,1601.9,5,1,1,7
1742,14715.0,10051,5041,61583.98000000001,2,4,4,10
1743,14716.0,4503,2601,15683.009999999997,3,3,3,9
1744,14719.0,20427,55225,371732.39999999997,1,5,5,11
1745,14720.0,2366,1369,24560.970000000005,4,3,3,10
1746,14722.0,4116,784,5051.759999999999,3,2,2,7
1747,14723.0,35612,67081,290691.24,1,5,5,11
1748,14725.0,1128,2209,30812.260000000006,5,3,3,11
1749,14727.0,2740,100,2685.7999999999997,4,1,1,6
1750,14729.0,26483,5041,22257.790000000005,1,4,3,8
1751,14730.0,52352,213444,876677.34,1,5,5,11
1752,14731.0,7023,2025,17100.899999999998,3,3,3,9
1753,14732.0,24196,21609,397266.02999999997,1,5,5,11
1754,14733.0,57439,40804,1936353.82,1,5,5,11
1755,14735.0,31261,37636,1176743.86,1,5,5,11
1756,14737.0,3726,289,19797.35,3,2,3,8
1757,14738.0,8816,2916,70980.3,2,3,4,9
1758,14739.0,9550,3600,234136.80000000002,2,4,5,11
1759,14740.0,20813,7921,128890.68999999999,1,4,4,9
1760,14741.0,10099,3481,82620.06,2,4,4,10
1761,14744.0,5815,676,28599.48,3,2,3,8
1762,14745.0,11247,4761,84197.94000000002,2,4,4,10
1763,14747.0,4482,324,5907.5999999999985,3,2,2,7
1764,14748.0,19162,7921,126001.75,1,4,4,9
1765,14752.0,215,25,1948.1999999999996,5,1,1,7
1766,14753.0,2610,900,16894.499999999996,4,3,3,10
1767,14754.0,5569,1681,26160.05,3,3,3,9
1768,14755.0,37086,55225,1177415.8,1,5,5,11
1769,14756.0,570,1444,28080.479999999992,5,3,3,11
1770,14757.0,1425,361,7989.500000000001,4,2,2,8
1771,14758.0,15533,5041,105368.26,2,4,4,10
1772,14759.0,10224,10404,165848.94,2,4,4,10
1773,14760.0,1485,25,446.0,4,1,1,6
1774,14761.0,2570,121,2814.9,4,1,1,6
1775,14762.0,5523,441,6310.92,3,2,2,7
1776,14764.0,276,36,1669.8000000000002,5,1,1,7
1777,14765.0,2243,1521,9910.29,4,3,2,9
1778,14766.0,23082,18225,333904.95,1,5,5,11
1779,14768.0,525,25,963.0,5,1,1,7
1780,14769.0,183500,1127844,11062832.76,1,5,5,11
1781,14770.0,13611,2704,45573.84,2,3,3,8
1782,14772.0,1008,81,1253.34,5,1,1,7
1783,14775.0,11340,3600,60714.0,2,4,4,10
1784,14776.0,19892,13689,296981.10000000003,1,4,5,10
1785,14778.0,7703,1225,25580.099999999995,3,3,3,9
1786,14779.0,12981,1681,15832.15,2,3,3,8
1787,14780.0,1933,729,12087.36,4,2,2,8
1788,14782.0,1914,36,1200.6,4,1,1,6
1789,14784.0,1578,225,4349.85,4,2,2,8
1790,14785.0,40,9,232.20000000000002,5,1,1,7
1791,14788.0,495,900,20383.199999999993,5,3,3,11
1792,14789.0,168,36,1185.84,5,1,1,7
1793,14790.0,5116,2116,34272.76,3,3,3,9
1794,14792.0,126,4,12.4,5,1,1,7
1795,14793.0,294,196,3205.86,5,1,1,7
1796,14794.0,10714,6400,105592.8,2,4,4,10
1797,14795.0,996,36,788.6999999999999,5,1,1,7
1798,14796.0,203596,1281424,9028254.68,1,5,5,11
1799,14798.0,2356,144,2084.88,4,1,1,6
1800,14799.0,663,169,2050.1000000000004,5,1,1,7
1801,14800.0,91885,146689,1659075.5700000003,1,5,5,11
1802,14801.0,3477,3249,10792.380000000001,4,3,2,9
1803,14803.0,9513,1936,37204.2,2,3,3,8
1804,14804.0,96,144,4239.24,5,1,2,8
1805,14805.0,6768,2116,25134.400000000005,3,3,3,9
1806,14806.0,825,121,2127.29,5,1,1,7
1807,14808.0,32049,53361,627996.6,1,5,5,11
1808,14810.0,54862,64516,529673.82,1,5,5,11
1809,14813.0,10701,841,4433.519999999999,2,2,2,6
1810,14815.0,3117,2809,41260.5,4,3,3,10
1811,14816.0,788,16,1087.4,5,1,1,7
1812,14817.0,15218,3969,69951.42,2,4,4,10
1813,14818.0,6996,2304,31574.399999999998,3,3,3,9
1814,14819.0,1216,169,3536.91,5,1,1,7
1815,14820.0,2299,841,14711.41,4,2,3,9
1816,14821.0,732,4,97.6,5,1,1,7
1817,14823.0,13244,4900,22500.099999999995,2,4,3,9
1818,14824.0,1866,841,32703.590000000015,4,2,3,9
1819,14825.0,23896,14400,266521.20000000007,1,4,5,10
1820,14828.0,4206,289,36375.920000000006,3,2,3,8
1821,14829.0,11292,1764,29297.1,2,3,3,8
1822,14830.0,2067,1521,7366.32,4,3,2,9
1823,14834.0,6262,4489,115260.09999999999,3,4,4,11
1824,14836.0,158,36,614.7,5,1,1,7
1825,14837.0,16067,11664,178146.00000000003,2,4,4,10
1826,14840.0,1068,16,251.4,5,1,1,7
1827,14841.0,30499,19044,454814.88,1,5,5,11
1828,14842.0,18637,21025,409580.05,2,5,5,12
1829,14844.0,19508,16900,414675.30000000005,1,5,5,11
1830,14847.0,1924,169,4022.2,4,1,2,7
1831,14849.0,61725,150544,3077049.52,1,5,5,11
1832,14850.0,6531,441,6840.75,3,2,2,7
1833,14851.0,3906,784,14317.799999999997,3,2,2,7
1834,14852.0,19820,20449,405646.67,1,5,5,11
1835,14853.0,777,81,4282.2,5,1,2,8
1836,14854.0,23394,15876,345243.78,1,5,5,11
1837,14855.0,2560,400,12913.0,4,2,2,8
1838,14856.0,3320,4225,83884.45,4,4,4,12
1839,14857.0,6121,3600,70387.2,3,4,4,11
1840,14859.0,4984,3364,78516.92,3,4,4,11
1841,14860.0,209,121,1873.52,5,1,1,7
1842,14861.0,312,36,754.7400000000001,5,1,1,7
1843,14862.0,3783,2304,40377.600000000006,3,3,3,9
1844,14863.0,319,121,2934.3599999999997,5,1,1,7
1845,14865.0,1123,16,208.8,5,1,1,7
1846,14866.0,7913,9801,1424600.0999999999,3,4,5,12
1847,14867.0,9453,1296,25570.079999999998,2,3,3,8
1848,14868.0,14811,20736,425316.96,2,5,5,12
1849,14869.0,5215,4900,50501.5,3,4,3,10
1850,14870.0,3393,169,4254.249999999999,4,1,2,7
1851,14871.0,15791,8649,46619.04,2,4,3,9
1852,14873.0,5880,784,14551.04,3,2,3,8
1853,14875.0,5804,2209,68870.03999999998,3,3,4,10
1854,14878.0,22539,14884,180082.97999999998,1,5,4,10
1855,14880.0,7066,2116,31767.140000000003,3,3,3,9
1856,14881.0,323,289,4341.8,5,2,2,9
1857,14882.0,328,121,6486.700000000001,5,1,2,8
1858,14883.0,6531,2809,40364.27,3,3,3,9
1859,14885.0,1965,225,11479.8,4,2,2,8
1860,14886.0,4536,324,6566.400000000001,3,2,2,7
1861,14887.0,474,36,11172.0,5,1,2,8
1862,14888.0,4140,400,7384.0,3,2,2,7
1863,14889.0,3360,100,1359.0,4,1,1,6
1864,14890.0,1771,49,879.5500000000001,4,1,1,6
1865,14891.0,5937,1089,18294.54,3,3,3,9
1866,14893.0,759,5329,90363.04999999999,5,4,4,13
1867,14894.0,1955,529,15082.249999999998,4,2,3,9
1868,14895.0,73882,248004,5547077.579999999,1,5,5,11
1869,14896.0,13924,1849,20157.11,2,3,3,8
1870,14897.0,4742,3025,75150.90000000001,3,3,4,10
1871,14898.0,14066,11881,138354.79,2,4,4,10
1872,14901.0,18085,9216,136443.84,2,4,4,10
1873,14902.0,500,400,6653.200000000001,5,2,2,9
1874,14903.0,59868,122500,978365.5,1,5,5,11
1875,14904.0,644,4761,70755.36,5,4,4,13
1876,14905.0,3353,289,10474.55,4,2,2,8
1877,14907.0,28019,27225,577681.5000000001,1,5,5,11
1878,14908.0,666,81,2500.2,5,1,1,7
1879,14910.0,1037,900,13030.5,5,3,2,10
1880,14911.0,735684,32171584,815129756.2399999,1,5,5,11
1881,14912.0,3652,729,23431.95,4,2,3,9
1882,14913.0,17463,7569,106786.41,2,4,4,10
1883,14915.0,2580,144,3689.76,4,1,1,6
1884,14916.0,11701,5929,97711.46,2,4,4,10
1885,14918.0,5955,2025,72456.74999999999,3,3,4,10
1886,14920.0,12084,3249,55732.89,2,3,4,9
1887,14921.0,11403,6084,102653.46,2,4,4,10
1888,14923.0,2200,1936,32960.4,4,3,3,10
1889,14924.0,2450,100,3100.5,4,1,1,6
1890,14929.0,352,121,2462.68,5,1,1,7
1891,14930.0,24008,16129,300095.92000000004,1,5,5,11
1892,14931.0,3842,1681,51564.880000000005,3,3,4,10
1893,14932.0,6205,289,6180.009999999999,3,2,2,7
1894,14934.0,14886,7569,164511.78,2,4,4,10
1895,14935.0,2970,100,17847.1,4,1,3,8
1896,14936.0,49983,132496,2961875.2800000003,1,5,5,11
1897,14937.0,2866,1156,55143.920000000006,4,3,4,11
1898,14944.0,25600,28900,1003042.5,1,5,5,11
1899,14946.0,42,9,302.70000000000005,5,1,1,7
1900,14947.0,1588,196,4071.4800000000005,4,1,2,7
1901,14948.0,7407,3969,69424.11,3,4,4,11
1902,14950.0,361,361,7052.8,5,2,2,9
1903,14951.0,1580,400,6233.800000000001,4,2,2,8
1904,14952.0,25627,19044,1117729.6199999999,1,5,5,11
1905,14953.0,1350,2916,15426.18,4,3,3,10
1906,14954.0,924,5929,22703.45,5,4,3,12
1907,14957.0,3036,144,701.88,4,1,1,6
1908,14958.0,8301,1681,19832.93,2,3,3,8
1909,14959.0,12623,3481,41029.77999999999,2,4,3,9
1910,14960.0,542,729,5974.29,5,2,2,9
1911,14961.0,55409,97344,2197940.16,1,5,5,11
1912,14962.0,1350,25,633.5000000000001,4,1,1,6
1913,14963.0,11622,36864,282689.27999999997,2,5,5,12
1914,14964.0,3211,169,2680.73,4,1,1,6
1915,14965.0,7776,6561,48283.29,3,4,3,10
1916,14966.0,504,1296,6588.72,5,3,2,10
1917,14967.0,294,36,2782.8,5,1,1,7
1918,14968.0,1110,1369,5460.830000000001,5,3,2,10
1919,14970.0,5185,1156,54130.04,3,3,4,10
1920,14971.0,6241,24025,170186.9,3,5,4,12
1921,14972.0,2304,324,2065.86,4,2,1,7
1922,14973.0,4554,1024,42062.399999999994,3,3,3,9
1923,14974.0,629,289,1528.98,5,2,1,8
1924,14975.0,627,121,3079.34,5,1,1,7
1925,14976.0,14490,5184,56941.92,2,4,4,10
1926,14978.0,54181,45796,411173.18000000005,1,5,5,11
1927,14981.0,1968,64,816.96,4,1,1,6
1928,14984.0,3317,1521,7892.43,4,3,2,9
1929,14985.0,23794,6889,24236.829999999998,1,4,3,8
1930,14987.0,760,16,1305.6,5,1,1,7
1931,14988.0,8440,1600,13381.6,2,3,2,7
1932,14995.0,11234,3600,13918.8,2,4,2,8
1933,14997.0,2888,676,14201.2,4,2,2,8
1934,14998.0,15562,5476,30700.38,2,4,3,9
1935,15000.0,3619,5929,37770.04,4,4,3,11
1936,15002.0,30051,13225,188802.39999999997,1,4,4,9
1937,15004.0,22638,23716,187998.58,1,5,4,10
1938,15005.0,188669,1236544,7000451.4399999995,1,5,5,11
1939,15006.0,6732,17424,63410.16,3,5,4,12
1940,15007.0,1908,144,1882.9200000000005,4,1,1,6
1941,15009.0,3740,32400,226697.39999999997,3,5,4,12
1942,15010.0,700,400,6178.8,5,2,2,9
1943,15012.0,23106,14884,49414.880000000005,1,5,3,9
1944,15014.0,1818,1089,8503.11,4,3,2,9
1945,15016.0,3440,400,3400.7999999999997,4,2,1,7
1946,15017.0,660,400,2511.6,5,2,1,8
1947,15018.0,5391,961,15382.51,3,3,3,9
1948,15019.0,17556,4356,16685.46,2,4,3,9
1949,15021.0,71062,197136,831065.88,1,5,5,11
1950,15022.0,3344,14641,103139.19,4,5,4,13
1951,15023.0,99598,305809,3716386.73,1,5,5,11
1952,15024.0,25461,23104,248737.36,1,5,5,11
1953,15025.0,2211,4489,24251.32,4,4,3,11
1954,15026.0,9780,3721,28609.0,2,4,3,9
1955,15027.0,6194,1225,37315.25,3,3,3,9
1956,15028.0,6410,2304,30102.240000000005,3,3,3,9
1957,15030.0,1088,49,3627.96,5,1,1,7
1958,15031.0,10036,12100,71850.90000000001,2,4,4,10
1959,15032.0,16612,2704,257873.2,2,3,5,10
1960,15033.0,67150,251001,1281147.18,1,5,5,11
1961,15034.0,61738,152100,1666922.4,1,5,5,11
1962,15035.0,2403,729,6823.71,4,2,2,8
1963,15036.0,14139,14161,51117.64,2,4,3,9
1964,15038.0,28769,15625,85717.5,1,5,4,10
1965,15039.0,312639,2181529,29195253.43,1,5,5,11
1966,15041.0,11220,4356,11875.38,2,4,2,8
1967,15042.0,995,25,679.6500000000001,5,1,1,7
1968,15043.0,93,9,1611.0,5,1,1,7
1969,15044.0,84914,197136,3389820.1199999996,1,5,5,11
1970,15045.0,2236,144,8827.920000000002,4,1,2,7
1971,15046.0,38527,40401,1023174.42,1,5,5,11
1972,15047.0,5918,484,7559.6399999999985,3,2,2,7
1973,15048.0,19628,8836,35814.0,1,4,3,8
1974,15049.0,819,9,363.51000000000005,5,1,1,7
1975,15050.0,4476,5776,132064.44,3,4,4,11
1976,15051.0,9508,20164,196437.12,2,5,4,11
1977,15052.0,8932,784,5816.44,2,2,2,6
1978,15053.0,8856,4761,47882.549999999996,2,4,3,9
1979,15054.0,3244,12996,34439.4,4,4,3,11
1980,15057.0,7755,625,37237.5,3,2,3,8
1981,15058.0,46465,70756,559275.64,1,5,5,11
1982,15059.0,41029,56169,317039.63999999996,1,5,5,11
1983,15060.0,1027,13225,33838.75000000001,5,4,3,12
1984,15061.0,91373,162409,21977258.419999998,1,5,5,11
1985,15062.0,13050,3249,56308.020000000004,2,3,4,9
1986,15063.0,1065,25,1854.0,5,1,1,7
1987,15065.0,30869,24025,489510.15,1,5,5,11
1988,15066.0,2226,1764,37530.78,4,3,3,10
1989,15067.0,13536,6724,143070.32,2,4,4,10
1990,15068.0,12974,10816,57549.44,2,4,4,10
1991,15069.0,12530,4900,77667.10000000002,2,4,4,10
1992,15070.0,372,1,106.2,5,1,1,7
1993,15071.0,4602,676,25533.82,3,2,3,8
1994,15073.0,8252,2916,56344.14000000001,2,3,4,9
1995,15074.0,4305,1681,30162.47,3,3,3,9
1996,15075.0,2079,729,20871.809999999998,4,2,3,9
1997,15076.0,8428,2401,43161.649999999994,2,3,3,8
1998,15078.0,74942,193600,4286968.4,1,5,5,11
1999,15079.0,12945,2209,42093.67,2,3,3,8
2000,15081.0,5716,1089,16658.4,3,3,3,9
2001,15083.0,1280,25,440.99999999999994,5,1,1,7
2002,15087.0,4215,225,4604.1,3,2,2,7
2003,15088.0,3037,3249,66123.98999999999,4,3,4,11
2004,15089.0,14776,21025,351021.80000000005,2,5,5,12
2005,15090.0,7084,529,8770.36,3,2,2,7
2006,15091.0,2010,900,14421.3,4,3,2,9
2007,15092.0,6882,676,11903.06,3,2,2,7
2008,15093.0,26509,11664,496478.16000000003,1,4,5,10
2009,15095.0,7997,2209,64418.2,2,3,4,9
2010,15096.0,462,121,2413.29,5,1,1,7
2011,15097.0,100,625,6202.0,5,2,2,9
2012,15098.0,546,9,119749.5,5,1,4,10
2013,15099.0,1932,529,9441.04,4,2,2,8
2014,15100.0,1072,9,2628.0,5,1,1,7
2015,15101.0,1468,64,2540.24,4,1,1,6
2016,15103.0,1800,1225,24617.599999999995,4,3,3,10
2017,15104.0,15540,4489,66567.18,2,4,4,10
2018,15105.0,7840,10201,232191.93000000002,3,4,4,11
2019,15106.0,16758,10000,142252.0,2,4,4,10
2020,15107.0,5913,289,5431.5,3,2,2,7
2021,15108.0,10325,3600,78015.0,2,4,4,10
2022,15109.0,6860,784,13578.600000000002,3,2,2,7
2023,15110.0,4658,1225,34863.5,3,3,3,9
2024,15111.0,9848,7056,131668.31999999998,2,4,4,10
2025,15113.0,4129,9409,340414.70999999996,3,4,5,12
2026,15114.0,26117,38809,543830.32,1,5,5,11
2027,15115.0,378,441,7142.31,5,2,2,9
2028,15116.0,5026,2025,60873.75,3,3,4,10
2029,15117.0,6766,6241,122590.62000000001,3,4,4,11
2030,15118.0,134,1,244.8,5,1,1,7
2031,15119.0,3430,196,3729.5999999999995,4,1,1,6
2032,15120.0,2793,441,7535.2199999999975,4,2,2,8
2033,15121.0,5684,784,12816.16,3,2,2,7
2034,15122.0,15720,6724,133969.95999999996,2,4,4,10
2035,15123.0,11289,11236,233126.86000000004,2,4,5,11
2036,15124.0,1851,225,2762.8500000000004,4,2,1,7
2037,15125.0,24856,16129,1464116.96,1,5,5,11
2038,15127.0,1040,256,6504.48,5,2,2,9
2039,15128.0,15669,10404,150042.0,2,4,4,10
2040,15129.0,15889,7056,289581.60000000003,2,4,5,11
2041,15130.0,3718,484,7262.420000000002,3,2,2,7
2042,15132.0,8773,2704,50852.36,2,3,3,8
2043,15133.0,6333,841,28490.179999999997,3,2,3,8
2044,15134.0,8233,5329,101323.27,2,4,4,10
2045,15135.0,2151,81,1251.4499999999998,4,1,1,6
2046,15136.0,3322,4624,87495.60000000003,4,4,4,12
2047,15139.0,3883,169,2326.48,3,1,1,5
2048,15140.0,12875,6400,188340.0,2,4,4,10
2049,15142.0,1196,676,12967.240000000002,5,2,2,9
2050,15143.0,3150,196,3632.2999999999997,4,1,1,6
2051,15144.0,25687,47089,1427955.4800000002,1,5,5,11
2052,15145.0,10659,4489,80046.91000000002,2,4,4,10
2053,15146.0,22925,8281,120771.56000000001,1,4,4,9
2054,15147.0,6720,784,17458.0,3,2,3,8
2055,15148.0,200,400,6025.8,5,2,2,9
2056,15149.0,3059,529,11978.4,4,2,2,8
2057,15150.0,42013,116281,1804343.53,1,5,5,11
2058,15152.0,24264,73441,1286081.9900000002,1,5,5,11
2059,15153.0,682,484,7243.5,5,2,2,9
2060,15154.0,5325,5041,18053.88,3,4,3,10
2061,15156.0,770,3025,52881.95,5,3,4,12
2062,15157.0,24830,15625,242008.75000000006,1,5,5,11
2063,15158.0,315,49,2809.8000000000006,5,1,1,7
2064,15159.0,89161,504100,13235117.1,1,5,5,11
2065,15160.0,1428,16,632.6400000000002,4,1,1,6
2066,15163.0,2262,841,8829.629999999997,4,2,2,8
2067,15164.0,16533,10201,83282.58,2,4,4,10
2068,15165.0,10071,729,13169.25,2,2,2,6
2069,15167.0,12480,1521,6193.199999999999,2,3,2,7
2070,15168.0,125,25,532.8,5,1,1,7
2071,15171.0,1655,25,6447.5,4,1,2,7
2072,15172.0,13371,12100,178645.5,2,4,4,10
2073,15174.0,3542,121,1493.25,4,1,1,6
2074,15175.0,1633,529,5155.220000000001,4,2,2,8
2075,15178.0,780,9,121.5,5,1,1,7
2076,15179.0,15822,8649,205246.35000000003,2,4,4,10
2077,15180.0,2202,36,525.0,4,1,1,6
2078,15181.0,2334,256,11031.68,4,2,2,8
2079,15182.0,6290,841,18062.649999999994,3,2,3,8
2080,15184.0,5018,3844,24936.399999999998,3,4,3,10
2081,15185.0,1470,441,6523.02,4,2,2,8
2082,15186.0,1806,361,7816.790000000001,4,2,2,8
2083,15187.0,7401,8281,434723.3800000001,3,4,5,12
2084,15189.0,32637,44944,3439782.680000001,1,5,5,11
2085,15192.0,11559,2601,53260.32000000001,2,3,4,9
2086,15193.0,1140,361,9487.08,5,2,2,9
2087,15194.0,62175,96100,2361124.3000000003,1,5,5,11
2088,15195.0,2,1,3861.0,5,1,2,8
2089,15197.0,4268,1024,34547.52,3,3,3,9
2090,15198.0,1080,100,1936.3999999999999,5,1,1,7
2091,15199.0,2182,169,16493.1,4,1,3,8
2092,15201.0,11812,4761,85321.26,2,4,4,10
2093,15203.0,20926,20164,259547.6,1,5,5,11
2094,15204.0,3213,81,2849.22,4,1,1,6
2095,15205.0,4153,1369,24169.88,3,3,3,9
2096,15206.0,892,81,3782.7000000000003,5,1,2,8
2097,15208.0,4034,1764,36545.04,3,3,3,9
2098,15210.0,4500,400,6623.6,3,2,2,7
2099,15211.0,10135,2704,46509.32,2,3,3,8
2100,15212.0,1205,25,508.9999999999999,5,1,1,7
2101,15213.0,7874,576,7880.400000000001,3,2,2,7
2102,15214.0,12923,12100,182758.4,2,4,4,10
2103,15215.0,2410,1225,25722.899999999998,4,3,3,10
2104,15216.0,174,4,193.2,5,1,1,7
2105,15218.0,28164,27556,955643.7400000001,1,5,5,11
2106,15219.0,1584,81,2751.75,4,1,1,6
2107,15220.0,19036,13689,208138.31999999995,1,4,4,9
2108,15221.0,1830,25,2016.25,4,1,1,6
2109,15222.0,1590,25,2925.0,4,1,1,6
2110,15223.0,4788,400,15115.0,3,2,3,8
2111,15224.0,5020,196,4509.119999999999,3,1,2,6
2112,15225.0,5382,529,9416.200000000003,3,2,2,7
2113,15226.0,2480,64,1235.28,4,1,1,6
2114,15227.0,12383,3364,70725.20000000001,2,4,4,10
2115,15228.0,19577,15625,423338.75,1,5,5,11
2116,15230.0,5519,529,9880.800000000001,3,2,2,7
2117,15232.0,3989,961,18973.86,3,3,3,9
2118,15234.0,3864,196,2758.0000000000014,3,1,1,5
2119,15235.0,42772,20449,321393.93000000005,1,5,5,11
2120,15236.0,4470,225,4815.749999999999,3,2,2,7
2121,15237.0,18243,9801,139819.68000000002,2,4,4,10
2122,15238.0,5138,2500,53599.5,3,3,4,10
2123,15239.0,2530,2401,38248.91,4,3,3,10
2124,15240.0,12326,6084,133112.46,2,4,4,10
2125,15241.0,20280,12100,193208.4,1,4,4,9
2126,15243.0,1628,484,6966.96,4,2,2,8
2127,15244.0,4955,1156,21473.379999999997,3,3,3,9
2128,15245.0,18997,7921,223909.76,1,4,4,9
2129,15246.0,9294,1089,16966.95,2,3,3,8
2130,15247.0,732,36,2136.0,5,1,1,7
2131,15249.0,55175,122500,2340960.9999999995,1,5,5,11
2132,15251.0,17776,12321,1163833.89,2,4,5,11
2133,15252.0,3642,1936,32594.32,4,3,3,10
2134,15253.0,4556,2809,48664.59999999999,3,3,3,9
2135,15254.0,2286,324,5406.480000000001,4,2,2,8
2136,15255.0,3102,2209,41869.950000000004,4,3,3,10
2137,15256.0,888,36,590.7,5,1,1,7
2138,15257.0,1981,49,2220.0499999999997,4,1,1,6
2139,15258.0,6496,1156,21187.440000000002,3,3,3,9
2140,15260.0,16769,5929,139429.29,2,4,4,10
2141,15261.0,2565,361,4841.58,4,2,2,8
2142,15262.0,3230,100,1789.5000000000002,4,1,1,6
2143,15263.0,1272,144,1878.1199999999994,5,1,1,7
2144,15264.0,1472,529,9056.020000000002,4,2,2,8
2145,15265.0,15910,6724,123501.84,2,4,4,10
2146,15266.0,2028,36,715.8,4,1,1,6
2147,15267.0,1364,121,18890.96,4,1,3,8
2148,15269.0,46,4,817.6,5,1,1,7
2149,15270.0,8995,1681,97559.09,2,3,4,9
2150,15271.0,34111,69696,658241.76,1,5,5,11
2151,15272.0,4374,3969,45482.22,3,4,3,10
2152,15274.0,538,2209,33678.79,5,3,3,11
2153,15275.0,1517,1681,25220.739999999998,4,3,3,10
2154,15276.0,3234,2401,6302.87,4,3,2,9
2155,15277.0,552,144,3070.8,5,1,1,7
2156,15279.0,6726,361,5519.69,3,2,2,7
2157,15280.0,2752,256,1809.92,4,2,1,7
2158,15281.0,33953,19321,324168.85000000003,1,5,5,11
2159,15286.0,147,9,721.6500000000001,5,1,1,7
2160,15287.0,1160,400,9733.8,5,2,2,9
2161,15288.0,22011,7744,202973.76000000004,1,4,4,9
2162,15289.0,8994,3364,54507.24,2,4,4,10
2163,15290.0,29829,41616,1620416.88,1,5,5,11
2164,15291.0,22978,10609,480834.90000000014,1,4,5,10
2165,15292.0,4824,576,4281.36,3,2,2,7
2166,15296.0,36162,37636,712534.84,1,5,5,11
2167,15297.0,1303,1521,25035.660000000003,5,3,3,11
2168,15298.0,29121,36864,921580.7999999999,1,5,5,11
2169,15299.0,1677,49,31549.07,4,1,3,8
2170,15300.0,1792,784,13900.32,4,2,2,8
2171,15301.0,41436,58564,1222087.8999999997,1,5,5,11
2172,15303.0,8990,961,17794.62,2,3,3,8
2173,15304.0,5011,529,15971.200000000004,3,2,3,8
2174,15306.0,5504,3364,68112.29999999999,3,4,4,11
2175,15307.0,1140,144,2463.6000000000004,5,1,1,7
2176,15308.0,5206,361,5898.93,3,2,2,7
2177,15311.0,449748,5597956,143457086.5,1,5,5,11
2178,15312.0,10061,2209,43467.950000000004,2,3,3,8
2179,15313.0,110,1,52.0,5,1,1,7
2180,15314.0,4776,576,7871.280000000001,3,2,2,7
2181,15315.0,3200,1369,21108.500000000004,4,3,3,10
2182,15316.0,326,1,165.0,5,1,1,7
2183,15318.0,99,1089,10316.460000000001,5,3,2,10
2184,15319.0,4528,256,3272.0,3,2,1,6
2185,15320.0,1584,1296,9616.680000000002,4,3,2,9
2186,15321.0,15048,9025,261089.45000000004,2,4,5,11
2187,15322.0,3570,1764,28546.559999999998,4,3,3,10
2188,15325.0,4944,2304,7763.52,3,3,2,8
2189,15326.0,9657,841,9039.589999999998,2,2,2,6
2190,15327.0,520,100,2087.5,5,1,1,7
2191,15329.0,6805,3249,59832.9,3,3,4,10
2192,15330.0,640,169,9294.48,5,1,2,8
2193,15332.0,12912,1225,58137.1,2,3,4,9
2194,15333.0,3328,256,16456.96,4,2,3,9
2195,15334.0,16005,9604,34380.36,2,4,3,9
2196,15335.0,1855,1225,5957.7,4,3,2,9
2197,15339.0,16008,7396,49370.02,2,4,3,9
2198,15341.0,1360,289,34348.84,4,2,3,9
2199,15342.0,3096,576,9746.16,4,2,2,8
2200,15343.0,1827,441,7654.5,4,2,2,8
2201,15344.0,1450,676,14662.439999999999,4,2,3,9
2202,15345.0,900,400,7870.8,5,2,2,9
2203,15346.0,5644,289,4291.139999999999,3,2,2,7
2204,15347.0,1830,25,1008.0,4,1,1,6
2205,15348.0,648,81,1422.36,5,1,1,7
2206,15349.0,12929,5041,32937.60999999999,2,4,3,9
2207,15350.0,1865,25,578.25,4,1,1,6
2208,15351.0,25822,47961,423690.5400000001,1,5,5,11
2209,15353.0,16850,3721,46977.32000000001,2,4,3,9
2210,15355.0,598,196,3878.7000000000007,5,1,2,8
2211,15356.0,105101,249001,1356296.9700000004,1,5,5,11
2212,15358.0,103884,303601,4599307.2,1,5,5,11
2213,15360.0,507,169,5563.09,5,1,2,8
2214,15361.0,2527,49,2932.4400000000005,4,1,1,6
2215,15363.0,5952,256,5216.0,3,2,2,7
2216,15364.0,3232,841,26482.510000000006,4,2,3,9
2217,15365.0,11447,12996,263832.48000000004,2,4,5,11
2218,15366.0,5564,1936,26510.440000000006,3,3,3,9
2219,15367.0,18715,9025,178371.05000000005,2,4,4,10
2220,15368.0,84,16,1787.7600000000002,5,1,1,7
2221,15370.0,18186,8836,224288.7,2,4,4,10
2222,15372.0,3699,729,54199.8,3,2,4,9
2223,15373.0,25087,17424,318900.12000000005,1,5,5,11
2224,15374.0,384,9,504.0,5,1,1,7
2225,15376.0,18507,13456,141700.95999999993,2,4,4,10
2226,15379.0,59392,37636,718438.26,1,5,5,11
2227,15380.0,3547,1296,60849.36,4,3,4,11
2228,15381.0,2089,64,4774.8,4,1,2,7
2229,15382.0,42547,91204,1798624.4199999997,1,5,5,11
2230,15384.0,10729,1681,26338.809999999998,2,3,3,8
2231,15385.0,480,144,3802.56,5,1,2,8
2232,15386.0,5766,961,12218.34,3,3,2,8
2233,15388.0,2700,100,1405.3999999999999,4,1,1,6
2234,15389.0,172,1,500.0,5,1,1,7
2235,15392.0,9850,7056,128984.52,2,4,4,10
2236,15393.0,2312,144,2782.32,4,1,1,6
2237,15394.0,16164,7225,185600.90000000002,2,4,4,10
2238,15395.0,2275,49,752.1500000000001,4,1,1,6
2239,15396.0,1568,196,4034.5199999999995,4,1,2,7
2240,15397.0,1734,36,564.0,4,1,1,6
2241,15398.0,3338,5329,98223.69000000002,4,4,4,12
2242,15399.0,1577,2500,40788.5,4,3,3,10
2243,15400.0,2347,144,8594.400000000001,4,1,2,7
2244,15402.0,7560,1764,26324.34,3,3,3,9
2245,15405.0,1512,64,2792.8,4,1,1,6
2246,15406.0,13253,2809,27067.629999999997,2,3,3,8
2247,15407.0,17008,21904,154917.52,2,5,4,11
2248,15408.0,8976,1156,9084.12,2,3,2,7
2249,15410.0,21209,14884,421002.4800000001,1,5,5,11
2250,15411.0,6736,9604,132195.14,3,4,4,11
2251,15412.0,1710,100,1905.3,4,1,1,6
2252,15414.0,1964,1521,30221.1,4,3,3,10
2253,15415.0,14711,2209,26301.66999999999,2,3,3,8
2254,15416.0,37984,36864,764989.4400000001,1,5,5,11
2255,15417.0,2380,784,14246.400000000001,4,2,2,8
2256,15419.0,192,64,1086.88,5,1,1,7
2257,15421.0,11031,2809,50369.08,2,3,3,8
2258,15422.0,1938,36,586.2,4,1,1,6
2259,15423.0,76,4,87.0,5,1,1,7
2260,15424.0,4318,289,6516.78,3,2,2,7
2261,15426.0,40967,75625,386119.25,1,5,5,11
2262,15427.0,10784,85264,417717.68,2,5,5,12
2263,15428.0,90,36,562.6800000000001,5,1,1,7
2264,15429.0,4435,6724,32582.7,3,4,3,10
2265,15432.0,230,100,1711.9,5,1,1,7
2266,15433.0,10353,1681,21865.3,2,3,3,8
2267,15434.0,5069,3025,57281.4,3,3,4,10
2268,15435.0,638,841,4329.410000000001,5,2,2,9
2269,15436.0,34497,84681,310715.25,1,5,5,11
2270,15437.0,11790,2025,9007.2,2,3,2,7
2271,15438.0,3275,625,3914.4999999999995,4,2,2,8
2272,15440.0,7412,3844,23788.16,3,4,3,10
2273,15442.0,496,4,1188.0,5,1,1,7
2274,15443.0,27635,138384,1195455.48,1,5,5,11
2275,15444.0,4003,45796,301998.9400000001,3,5,5,13
2276,15445.0,1320,25,567.5,5,1,1,7
2277,15447.0,2970,81,1396.53,4,1,1,6
2278,15448.0,8736,784,13849.92,2,2,2,6
2279,15449.0,9668,3600,58471.2,2,4,4,10
2280,15450.0,900,900,12895.199999999999,5,3,2,10
2281,15452.0,11637,3136,29594.88,2,3,3,8
2282,15453.0,25492,77841,382723.83,1,5,5,11
2283,15454.0,9050,625,4477.500000000001,2,2,2,6
2284,15456.0,18314,3364,25206.219999999998,2,4,3,9
2285,15457.0,15196,3364,13750.06,2,4,2,8
2286,15458.0,175,49,1131.48,5,1,1,7
2287,15460.0,19824,3136,11998.56,1,3,2,6
2288,15462.0,1597,121,2580.6,4,1,1,6
2289,15463.0,203,49,882.98,5,1,1,7
2290,15464.0,52390,24025,161920.75,1,5,4,10
2291,15465.0,21280,9409,713398.1399999999,1,4,5,10
2292,15466.0,4845,3249,19068.210000000003,3,3,3,9
2293,15467.0,5982,2704,27293.76,3,3,3,9
2294,15468.0,1224,576,11220.24,5,2,2,9
2295,15469.0,2320,576,12925.2,4,2,2,8
2296,15471.0,146,5329,33177.04,5,4,3,12
2297,15472.0,8588,5776,28238.56000000001,2,4,3,9
2298,15473.0,528,121,19483.2,5,1,3,9
2299,15475.0,2233,841,13169.19,4,2,2,8
2300,15478.0,2144,1936,61596.479999999996,4,3,4,11
2301,15480.0,5220,2025,40747.5,3,3,3,9
2302,15482.0,7403,9409,1055336.72,3,4,5,12
2303,15483.0,18984,7056,18921.84,1,4,3,8
2304,15484.0,10039,34969,671406.67,2,5,5,12
2305,15485.0,16216,7225,217982.5,2,4,4,10
2306,15488.0,184,4,182.64,5,1,1,7
2307,15489.0,6077,2500,56714.0,3,3,4,10
2308,15491.0,30096,23716,477413.86000000004,1,5,5,11
2309,15492.0,2268,1225,23081.099999999995,4,3,3,10
2310,15493.0,47217,83521,564535.49,1,5,5,11
2311,15494.0,11262,14884,156230.75999999998,2,5,4,11
2312,15497.0,3275,225,18933.0,4,2,3,9
2313,15498.0,102420,262144,6817996.8,1,5,5,11
2314,15500.0,2374,4624,76946.08000000002,4,4,4,12
2315,15502.0,38378,45369,2211990.09,1,5,5,11
2316,15503.0,23892,4356,9308.64,1,4,2,7
2317,15504.0,1053,169,686.79,5,1,1,7
2318,15505.0,9563,9409,350263.12,2,4,5,11
2319,15506.0,10425,25921,156504.88,2,5,4,11
2320,15507.0,7695,2025,21413.700000000004,3,3,3,9
2321,15508.0,19416,8464,92024.84,1,4,4,9
2322,15510.0,330,1,250.0,5,1,1,7
2323,15511.0,7291,24964,142283.74,3,5,4,12
2324,15512.0,2309,49,847.0,4,1,1,6
2325,15513.0,54435,94864,4545531.76,1,5,5,11
2326,15514.0,33826,27556,667937.52,1,5,5,11
2327,15516.0,688,225,936.45,5,2,1,8
2328,15517.0,6291,729,7209.81,3,2,2,7
2329,15518.0,43165,44100,403525.5,1,5,5,11
2330,15520.0,18,324,6183.0,5,2,2,9
2331,15521.0,33506,34225,555037.0,1,5,5,11
2332,15522.0,4047,3136,22287.440000000002,3,3,3,9
2333,15523.0,840,100,4120.1,5,1,2,8
2334,15524.0,24,1,440.0,5,1,1,7
2335,15525.0,18660,24336,114561.71999999999,2,5,4,11
2336,15526.0,132,16,593.76,5,1,1,7
2337,15527.0,22819,26244,393421.8600000001,1,5,5,11
2338,15528.0,6604,676,5962.58,3,2,2,7
2339,15529.0,109526,438244,2623241.1999999997,1,5,5,11
2340,15530.0,19772,11449,160212.17,1,4,4,9
2341,15531.0,5734,47961,431953.41000000003,3,5,5,13
2342,15532.0,41783,63001,392747.23,1,5,5,11
2343,15533.0,4580,6889,67028.31,3,4,4,11
2344,15535.0,18602,5184,36208.799999999996,2,4,3,9
2345,15537.0,3912,576,2662.0800000000004,3,2,1,6
2346,15539.0,287,1681,22076.86,5,3,3,11
2347,15540.0,165,225,3199.5000000000005,5,2,1,8
2348,15541.0,3306,841,2468.77,4,2,1,7
2349,15543.0,8064,784,3580.08,2,2,1,5
2350,15544.0,47853,67081,918597.8900000001,1,5,5,11
2351,15545.0,14147,6400,23117.600000000002,2,4,3,9
2352,15547.0,105483,483025,3412867.0000000005,1,5,5,11
2353,15549.0,26558,12996,191686.44,1,4,4,9
2354,15550.0,8670,3721,35113.430000000015,2,4,3,9
2355,15551.0,1044,841,12645.74,5,2,2,9
2356,15552.0,3689,289,1532.04,3,2,1,6
2357,15553.0,3300,3025,23591.15,4,3,3,10
2358,15554.0,3878,196,3040.7999999999997,3,1,1,5
2359,15555.0,122774,786769,4253040.819999999,1,5,5,11
2360,15556.0,744,961,8672.869999999999,5,3,2,10
2361,15557.0,532,361,8909.29,5,2,2,9
2362,15561.0,2967,729,21615.929999999997,4,2,3,9
2363,15562.0,351,1,134.55,5,1,1,7
2364,15563.0,16998,12769,158249.72,2,4,4,10
2365,15565.0,480,64,1385.2800000000004,5,1,1,7
2366,15567.0,126,49,1302.07,5,1,1,7
2367,15568.0,2198,2809,40189.369999999995,4,3,3,10
2368,15569.0,5417,961,42647.01,3,3,3,9
2369,15570.0,74852,101761,1323473.5799999998,1,5,5,11
2370,15571.0,2472,3249,37074.51,4,3,3,10
2371,15572.0,29943,44944,537085.04,1,5,5,11
2372,15573.0,5923,9409,57345.42999999999,3,4,4,11
2373,15574.0,54257,23104,102697.28,1,5,4,10
2374,15576.0,1591,1849,39618.91,4,3,3,10
2375,15577.0,6505,1521,10096.320000000002,3,3,2,8
2376,15578.0,2106,169,1652.3,4,1,1,6
2377,15579.0,9389,2304,15724.800000000001,2,3,3,8
2378,15581.0,37907,21609,540338.19,1,5,5,11
2379,15582.0,6432,1936,30048.040000000005,3,3,3,9
2380,15584.0,9538,14884,87944.92000000001,2,5,4,11
2381,15585.0,5456,961,14114.300000000001,3,3,2,8
2382,15587.0,1615,81,8223.119999999999,4,1,2,7
2383,15589.0,8055,841,13877.369999999999,2,2,2,6
2384,15592.0,1104,576,9325.92,5,2,2,9
2385,15593.0,350,25,999.0,5,1,1,7
2386,15594.0,10194,10609,182493.34000000003,2,4,4,10
2387,15596.0,22912,5929,108307.43,1,4,4,9
2388,15597.0,770,484,7140.54,5,2,2,9
2389,15598.0,742,196,3369.52,5,1,1,7
2390,15599.0,6514,2704,39610.48,3,3,3,9
2391,15601.0,99042,168100,2778389.6,1,5,5,11
2392,15602.0,6380,2209,60999.88999999999,3,3,4,10
2393,15603.0,156,4,96.96,5,1,1,7
2394,15604.0,884,289,3678.6299999999997,5,2,1,8
2395,15605.0,13130,4489,80281.41,2,4,4,10
2396,15606.0,17094,5929,224852.31999999998,2,4,4,10
2397,15607.0,4368,169,1361.88,3,1,1,5
2398,15608.0,4616,3600,65620.8,3,4,4,11
2399,15609.0,2944,256,4775.68,4,2,2,8
2400,15610.0,306,36,674.76,5,1,1,7
2401,15611.0,5017,1849,68432.35000000002,3,3,4,10
2402,15612.0,291,36,1170.9,5,1,1,7
2403,15615.0,70728,178929,4399090.02,1,5,5,11
2404,15618.0,3408,2025,34958.29500000001,4,3,3,10
2405,15619.0,30,9,1009.2,5,1,1,7
2406,15620.0,19718,10000,155317.99999999997,1,4,4,9
2407,15621.0,143,256,20688.48,5,2,3,10
2408,15622.0,35512,34225,686268.6,1,5,5,11
2409,15623.0,2679,361,5719.57,4,2,2,8
2410,15624.0,6311,1156,19996.42,3,3,3,9
2411,15625.0,12320,4096,98192.64,2,4,4,10
2412,15626.0,8726,2401,33114.200000000004,2,3,3,8
2413,15628.0,22220,24025,444887.19999999995,1,5,5,11
2414,15630.0,6039,3600,71181.0,3,4,4,11
2415,15632.0,25507,27889,548646.77,1,5,5,11
2416,15634.0,255,225,3653.25,5,2,1,8
2417,15636.0,3769,625,18119.0,3,2,3,8
2418,15637.0,780,225,3350.4,5,2,1,8
2419,15639.0,3350,625,10633.0,4,2,2,8
2420,15640.0,85147,226576,5910068.36,1,5,5,11
2421,15641.0,27867,14161,224576.80000000002,1,4,4,9
2422,15643.0,8396,1089,21912.0,2,3,3,8
2423,15644.0,48927,53824,186421.28,1,5,4,10
2424,15645.0,936,2704,31824.52,5,3,3,11
2425,15646.0,10129,1225,15667.4,2,3,3,8
2426,15648.0,5589,576,15348.0,3,2,3,8
2427,15649.0,703,4,1632.0,5,1,1,7
2428,15651.0,4736,1024,20681.6,3,3,3,9
2429,15652.0,1911,441,7092.54,4,2,2,8
2430,15653.0,644,36,5264.639999999999,5,1,2,8
2431,15654.0,342,441,19373.13,5,2,3,10
2432,15655.0,8262,1156,19062.780000000002,2,3,3,8
2433,15656.0,8528,2209,35179.5,2,3,3,8
2434,15657.0,22,1,30.0,5,1,1,7
2435,15658.0,13147,2304,49156.799999999996,2,3,3,8
2436,15659.0,473,121,3370.9500000000007,5,1,1,7
2437,15660.0,14260,8100,144077.4,2,4,4,10
2438,15661.0,1606,25,1549.0,4,1,1,6
2439,15663.0,954,81,1243.2599999999998,5,1,1,7
2440,15664.0,850,289,6569.31,5,2,2,9
2441,15665.0,25020,13225,255554.15,1,4,5,10
2442,15667.0,507,169,3917.1600000000008,5,1,2,8
2443,15668.0,217,1,76.32000000000001,5,1,1,7
2444,15669.0,5992,1089,22583.22,3,3,3,9
2445,15670.0,3552,144,2076.6000000000004,4,1,1,6
2446,15671.0,14953,6084,207256.14,2,4,4,10
2447,15673.0,28452,19044,376219.74000000005,1,5,5,11
2448,15674.0,18208,12996,278912.4,2,4,5,11
2449,15675.0,3260,441,6797.49,4,2,2,8
2450,15676.0,22096,40804,694023.52,1,5,5,11
2451,15677.0,1617,1089,21688.59,4,3,3,10
2452,15678.0,624,144,4232.400000000001,5,1,2,8
2453,15679.0,6368,12100,85940.8,3,4,4,11
2454,15680.0,12435,6084,104027.04,2,4,4,10
2455,15681.0,8072,2809,75586.48000000001,2,3,4,9
2456,15683.0,1170,100,1937.5,5,1,1,7
2457,15687.0,30267,27556,496854.6,1,5,5,11
2458,15689.0,2523,81,2286.9,4,1,1,6
2459,15690.0,844,361,4555.44,5,2,2,9
2460,15691.0,504,4,273.6,5,1,1,7
2461,15692.0,336,144,2292.48,5,1,1,7
2462,15694.0,13340,6084,505393.19999999995,2,4,5,11
2463,15695.0,5852,484,9019.560000000001,3,2,2,7
2464,15696.0,32340,28224,455466.48000000004,1,5,5,11
2465,15699.0,306,324,5573.699999999999,5,2,2,9
2466,15700.0,14877,7396,59914.47999999999,2,4,4,10
2467,15701.0,18974,52900,351670.0,1,5,5,11
2468,15703.0,1320,25,1057.5,5,1,1,7
2469,15704.0,21174,13689,268353.54,1,4,5,10
2470,15705.0,1206,36,858.6000000000001,5,1,1,7
2471,15706.0,5280,3025,58330.799999999996,3,3,4,10
2472,15707.0,10979,42025,187980.89999999997,2,5,4,11
2473,15708.0,62020,74529,883223.25,1,5,5,11
2474,15709.0,1698,36,799.5,4,1,1,6
2475,15712.0,8509,2809,56835.079999999994,2,3,4,9
2476,15713.0,4724,361,6777.3,3,2,2,7
2477,15714.0,704,1156,11221.019999999999,5,3,2,10
2478,15716.0,29453,13689,128829.87,1,4,4,9
2479,15717.0,1638,49,1052.1000000000001,4,1,1,6
2480,15719.0,173886,866761,4682995.17,1,5,5,11
2481,15720.0,3072,16384,76637.44,4,5,4,13
2482,15721.0,924,7056,39597.600000000006,5,4,3,12
2483,15722.0,9364,4489,148151.07000000004,2,4,4,10
2484,15723.0,13832,1444,7246.599999999999,2,3,2,7
2485,15724.0,2626,121,2400.75,4,1,1,6
2486,15725.0,480,1024,13288.0,5,3,2,10
2487,15727.0,61298,90601,1552877.06,1,5,5,11
2488,15729.0,1060,25,425.0,5,1,1,7
2489,15730.0,9125,4900,78461.6,2,4,4,10
2490,15732.0,3768,196,4117.679999999999,3,1,2,6
2491,15733.0,2820,100,1623.0,4,1,1,6
2492,15734.0,3910,676,34825.700000000004,3,2,3,8
2493,15737.0,12192,5041,84356.51999999999,2,4,4,10
2494,15738.0,34205,29929,832548.66,1,5,5,11
2495,15739.0,528,64,3592.96,5,1,1,7
2496,15740.0,441,81,1393.9200000000003,5,1,1,7
2497,15743.0,6561,7396,66732.56,3,4,4,11
2498,15744.0,231,9,104.39999999999999,5,1,1,7
2499,15745.0,6294,3844,67864.58,3,4,4,11
2500,15746.0,3752,784,5512.639999999999,3,2,2,7
2501,15747.0,6712,8100,85197.6,3,4,4,11
2502,15748.0,800,400,2887.2000000000003,5,2,1,8
2503,15749.0,2835,100,445343.0,4,1,5,10
2504,15750.0,38733,84681,716747.55,1,5,5,11
2505,15752.0,67275,164025,1063773.0000000002,1,5,5,11
2506,15753.0,304,1,79.2,5,1,1,7
2507,15754.0,2884,784,12839.96,4,2,2,8
2508,15755.0,17832,19881,333359.25,2,5,5,12
2509,15756.0,30586,36481,100849.91,1,5,4,10
2510,15757.0,5357,2025,32148.9,3,3,3,9
2511,15758.0,216,81,1847.25,5,1,1,7
2512,15759.0,2242,49,1771.28,4,1,1,6
2513,15762.0,2669,1369,21598.75,4,3,3,10
2514,15763.0,3409,3721,66302.12000000002,4,4,4,12
2515,15764.0,31734,32400,590394.6,1,5,5,11
2516,15766.0,704,121,3465.6599999999994,5,1,1,7
2517,15768.0,4909,729,16789.41,3,2,3,8
2518,15769.0,21376,16900,7312853.600000001,1,5,5,11
2519,15773.0,50,100,6356.800000000001,5,1,2,8
2520,15774.0,1700,625,6769.999999999999,4,2,2,8
2521,15775.0,1715,49,734.3000000000001,4,1,1,6
2522,15776.0,2394,324,4349.16,4,2,2,8
2523,15777.0,5813,441,21989.309999999998,3,2,3,8
2524,15780.0,8162,841,13783.119999999999,2,2,2,6
2525,15781.0,2572,400,6909.200000000001,4,2,2,8
2526,15782.0,2587,1849,112433.81999999999,4,3,4,11
2527,15783.0,140,196,3448.2000000000003,5,1,1,7
2528,15785.0,14173,6889,193304.51,2,4,4,10
2529,15786.0,23456,70756,1308454.0,1,5,5,11
2530,15787.0,8000,40000,186652.0,2,5,4,11
2531,15789.0,8950,625,8782.5,2,2,2,6
2532,15790.0,340,1156,7437.500000000001,5,3,2,10
2533,15791.0,11919,5625,120951.75,2,4,4,10
2534,15793.0,1055,144,11587.32,5,1,2,8
2535,15795.0,6258,1764,25620.42,3,3,3,9
2536,15796.0,18719,17424,357536.52,2,5,5,12
2537,15797.0,2166,64,17659.2,4,1,3,8
2538,15799.0,14698,9604,86645.72,2,4,4,10
2539,15800.0,14465,13689,81536.13,2,4,4,10
2540,15801.0,4211,4096,68092.8,3,4,4,11
2541,15802.0,142,1,451.42,5,1,1,7
2542,15803.0,408,64,3326.560000000001,5,1,1,7
2543,15804.0,25992,69169,1106280.5699999998,1,5,5,11
2544,15805.0,47076,89401,1640965.82,1,5,5,11
2545,15806.0,5883,961,24321.979999999996,3,3,3,9
2546,15807.0,3480,2304,43387.2,4,3,3,10
2547,15808.0,66798,38025,711997.65,1,5,5,11
2548,15809.0,7258,1225,18051.95,3,3,3,9
2549,15810.0,20206,7921,123886.22,1,4,4,9
2550,15811.0,25057,17689,295076.45999999996,1,5,5,11
2551,15812.0,7682,1681,73846.74,3,3,4,10
2552,15813.0,9208,1600,52156.4,2,3,4,9
2553,15814.0,2764,5184,140063.76,4,4,4,12
2554,15815.0,8170,2401,102929.4,2,3,4,9
2555,15819.0,22702,15129,234370.35000000006,1,5,5,11
2556,15820.0,5423,289,3518.66,3,2,1,6
2557,15821.0,3306,3844,35399.52,4,4,3,11
2558,15822.0,5795,1089,29220.51,3,3,3,9
2559,15823.0,372,1,15.0,5,1,1,7
2560,15825.0,3440,400,10658.800000000001,4,2,2,8
2561,15826.0,8120,4624,112493.08000000002,2,4,4,10
2562,15827.0,24501,13225,211150.34999999998,1,4,4,9
2563,15829.0,6115,2601,32443.13999999999,3,3,3,9
2564,15830.0,1443,1521,22464.0,4,3,3,10
2565,15831.0,8746,4356,52446.24,2,4,4,10
2566,15832.0,13716,2916,45186.66,2,3,3,8
2567,15834.0,55214,72361,598565.35,1,5,5,11
2568,15835.0,9703,2500,47704.5,2,3,3,8
2569,15836.0,500,100,1373.7,5,1,1,7
2570,15837.0,1536,576,9407.52,4,2,2,8
2571,15838.0,24214,27889,5618394.359999999,1,5,5,11
2572,15839.0,5709,3844,65006.38,3,4,4,11
2573,15840.0,3504,729,9600.119999999999,4,2,2,8
2574,15841.0,7938,2209,57530.82,2,3,4,9
2575,15843.0,2424,64,951.6000000000001,4,1,1,6
2576,15844.0,506,121,1438.1399999999999,5,1,1,7
2577,15845.0,23518,19044,512224.26,1,5,5,11
2578,15847.0,3086,484,8563.939999999999,4,2,2,8
2579,15850.0,8323,8649,21843.84,2,4,3,9
2580,15852.0,4323,484,3535.6199999999994,3,2,1,6
2581,15853.0,1530,900,3324.0,4,3,1,8
2582,15854.0,23771,19044,409738.56,1,5,5,11
2583,15855.0,15164,6400,56979.2,2,4,4,10
2584,15856.0,87381,394384,10138205.92,1,5,5,11
2585,15857.0,252,196,4157.999999999999,5,1,2,8
2586,15858.0,36886,35344,268383.16000000003,1,5,5,11
2587,15860.0,23426,19321,134157.24,1,5,4,10
2588,15861.0,51471,291600,1699336.8,1,5,5,11
2589,15862.0,30396,21609,122433.36,1,5,4,10
2590,15863.0,784,324,1239.1200000000001,5,2,1,8
2591,15864.0,2967,400,38726.40000000001,4,2,3,9
2592,15865.0,5088,1600,35805.2,3,3,3,9
2593,15866.0,4343,1849,9111.269999999999,3,3,2,8
2594,15867.0,90067,210681,1748854.26,1,5,5,11
2595,15869.0,4155,225,2244.6,3,2,1,6
2596,15870.0,2368,5476,26006.560000000005,4,4,3,11
2597,15872.0,1512,11664,34155.00000000001,4,4,3,11
2598,15874.0,23213,14400,528705.6,1,4,5,10
2599,15877.0,1822,15876,61781.579999999994,4,5,4,13
2600,15880.0,35424,9216,31586.879999999997,1,4,3,8
2601,15881.0,9253,841,14540.31,2,2,3,7
2602,15882.0,7274,529,11876.28,3,2,2,7
2603,15883.0,718,2401,19427.52,5,3,3,11
2604,15885.0,1889,324,6828.3,4,2,2,8
2605,15886.0,720,144,2173.0800000000004,5,1,1,7
2606,15888.0,960,144,2019.72,5,1,1,7
2607,15889.0,25827,7225,35705.95,1,4,3,8
2608,15891.0,13560,3600,30700.8,2,4,3,9
2609,15894.0,13305,1369,9555.25,2,3,2,7
2610,15895.0,1639,121,1970.8700000000001,4,1,1,6
2611,15897.0,4268,484,4588.9800000000005,3,2,2,7
2612,15898.0,25349,7056,116241.71999999997,1,4,4,9
2613,15899.0,1472,16,225.0,4,1,1,6
2614,15900.0,1081,2209,15852.160000000002,5,3,3,11
2615,15901.0,7589,12321,39042.03,3,4,3,10
2616,15903.0,9379,5476,379380.24,2,4,5,11
2617,15904.0,240,900,4940.4,5,3,2,10
2618,15906.0,20198,22500,235153.49999999997,1,5,5,11
2619,15907.0,21269,51076,199494.72,1,5,4,10
2620,15909.0,1211,49,1343.58,5,1,1,7
2621,15910.0,42548,70756,326882.08,1,5,5,11
2622,15912.0,4097,361,5027.779999999999,3,2,2,7
2623,15916.0,23232,22801,226931.86,1,5,4,10
2624,15917.0,2964,144,1477.1999999999998,4,1,1,6
2625,15918.0,9382,1600,13369.2,2,3,2,7
2626,15919.0,15929,14884,64134.17999999999,2,5,4,11
2627,15920.0,9240,3600,10050.0,2,4,2,8
2628,15921.0,4128,576,7752.719999999999,3,2,2,7
2629,15922.0,4103,121,4064.5000000000005,3,1,2,6
2630,15923.0,7812,441,2668.68,3,2,1,6
2631,15925.0,2328,144,2485.8,4,1,1,6
2632,15930.0,1407,441,8959.230000000001,4,2,2,8
2633,15932.0,18096,13225,287025.05000000005,2,4,5,11
2634,15933.0,4264,5476,81952.04000000004,3,4,4,11
2635,15935.0,2870,144,5002.32,4,1,2,7
2636,15937.0,448,49,1017.4499999999999,5,1,1,7
2637,15938.0,4050,324,7282.44,3,2,2,7
2638,15939.0,17865,5776,464740.75999999995,2,4,5,11
2639,15940.0,311,1,35.8,5,1,1,7
2640,15942.0,1862,196,4724.159999999999,4,1,2,7
2641,15944.0,1656,36,1950.6000000000001,4,1,1,6
2642,15945.0,730,4,362.0,5,1,1,7
2643,15947.0,2378,841,49538.96,4,2,3,9
2644,15948.0,1880,3600,57314.4,4,4,4,12
2645,15949.0,964,361,6929.68,5,2,2,9
2646,15950.0,15820,9409,169236.87,2,4,4,10
2647,15951.0,6422,1681,29037.02,3,3,3,9
2648,15952.0,8057,7056,65680.44,2,4,4,10
2649,15953.0,14769,9409,160756.16,2,4,4,10
2650,15955.0,23732,33489,808175.5800000001,1,5,5,11
2651,15957.0,1302,1764,18013.38,5,3,3,11
2652,15958.0,518,49,730.4499999999999,5,1,1,7
2653,15963.0,1000,784,13181.280000000002,5,2,2,9
2654,15965.0,8389,12321,89784.57,2,4,4,10
2655,15967.0,11575,6400,31814.4,2,4,3,9
2656,15969.0,2152,400,13321.999999999998,4,2,2,8
2657,15970.0,3333,121,3455.1000000000004,4,1,1,6
2658,15971.0,5237,1225,146994.75,3,3,4,10
2659,15973.0,1464,16,1231.28,4,1,1,6
2660,15974.0,30385,30976,605818.4,1,5,5,11
2661,15975.0,2016,576,8904.24,4,2,2,8
2662,15976.0,18590,9216,41053.44,2,4,3,9
2663,15977.0,1721,4225,68557.45,4,4,4,12
2664,15978.0,3773,2401,53840.22,3,3,4,10
2665,15980.0,7104,1849,103150.98000000001,3,3,4,10
2666,15981.0,14689,9409,330622.56,2,4,5,11
2667,15983.0,30027,12544,164093.44,1,4,4,9
2668,15984.0,35725,66564,717402.54,1,5,5,11
2669,15985.0,7602,1369,42269.53999999999,3,3,3,9
2670,15986.0,420,196,2353.68,5,1,1,7
2671,15987.0,14072,16384,183394.56,2,5,4,11
2672,15988.0,494,676,4076.28,5,2,2,9
2673,15990.0,7877,2704,41189.72000000001,3,3,3,9
2674,15992.0,9,9,125.97,5,1,1,7
2675,15993.0,17630,294849,1508274.81,2,5,5,12
2676,15994.0,1728,1024,13256.64,4,3,2,9
2677,15996.0,30407,16129,131137.66,1,5,4,10
2678,15998.0,104658,254016,1552430.8800000001,1,5,5,11
2679,16000.0,18,81,111543.3,5,1,4,10
2680,16003.0,14631,10609,281743.11,2,4,5,11
2681,16005.0,21538,40401,116320.71,1,5,4,10
2682,16006.0,1688,64,811.2,4,1,1,6
2683,16007.0,45165,145161,645341.61,1,5,5,11
2684,16008.0,2417,1089,15799.74,4,3,3,10
2685,16009.0,10200,6724,79713.02,2,4,4,10
2686,16010.0,22368,6241,30999.6,1,4,3,8
2687,16011.0,38138,44100,704121.6,1,5,5,11
2688,16012.0,8774,8836,133037.26,2,4,4,10
2689,16013.0,16522,19321,5161153.4,2,5,5,12
2690,16014.0,28118,19044,89262.54,1,5,4,10
2691,16015.0,5626,32761,127523.54999999999,3,5,4,12
2692,16016.0,38652,50176,328274.24,1,5,5,11
2693,16017.0,1504,1024,6780.16,4,3,2,9
2694,16018.0,3207,784,11449.199999999999,4,2,2,8
2695,16019.0,29910,25600,605798.3999999999,1,5,5,11
2696,16020.0,2010,2116,39146.46,4,3,3,10
2697,16022.0,18460,5041,42786.73000000001,2,4,3,9
2698,16023.0,15912,10201,72700.81,2,4,4,10
2699,16024.0,756,3969,15814.89,5,4,3,12
2700,16025.0,812,784,12310.480000000001,5,2,2,9
2701,16026.0,1376,1024,7554.88,4,3,2,9
2702,16027.0,3148,256,14953.92,4,2,3,9
2703,16029.0,44616,58081,19485052.439999998,1,5,5,11
2704,16030.0,8961,841,9605.960000000001,2,2,2,6
2705,16031.0,15061,9604,53694.20000000001,2,4,4,10
2706,16033.0,171426,1272384,9902508.959999999,1,5,5,11
2707,16034.0,5644,484,9629.399999999998,3,2,2,7
2708,16036.0,6721,3025,41740.59999999999,3,3,3,9
2709,16037.0,12141,1521,33345.780000000006,2,3,3,8
2710,16038.0,4548,676,12266.279999999999,3,2,2,7
2711,16040.0,10683,4225,85380.75000000001,2,4,4,10
2712,16041.0,735,36,18998.4,5,1,3,9
2713,16042.0,5040,4900,82422.90000000001,3,4,4,11
2714,16043.0,8779,1521,30185.61,2,3,3,8
2715,16045.0,19304,6889,111278.1,1,4,4,9
2716,16048.0,2984,64,2051.5200000000004,4,1,1,6
2717,16049.0,16145,89401,321368.19,2,5,5,12
2718,16050.0,1730,100,1378.9999999999998,4,1,1,6
2719,16052.0,1836,1156,12310.04,4,3,2,9
2720,16053.0,8268,7056,127003.80000000005,2,4,4,10
2721,16054.0,10150,4900,54873.00000000001,2,4,4,10
2722,16055.0,1760,64,1078.4,4,1,1,6
2723,16056.0,2970,4356,42949.5,4,4,3,11
2724,16057.0,18396,14641,273837.51999999996,2,5,5,12
2725,16059.0,37615,31684,258662.48,1,5,5,11
2726,16062.0,10197,4096,73831.68,2,4,4,10
2727,16063.0,5980,529,7712.3600000000015,3,2,2,7
2728,16065.0,26645,5329,26801.219999999998,1,4,3,8
2729,16066.0,4758,10201,153625.04000000004,3,4,4,11
2730,16070.0,916,1089,28120.95,5,3,3,11
2731,16071.0,924,441,6851.04,5,2,2,9
2732,16072.0,6624,529,13439.36,3,2,2,7
2733,16073.0,297,1,122.4,5,1,1,7
2734,16076.0,13201,16641,288280.17,2,5,5,12
2735,16078.0,283,1,79.2,5,1,1,7
2736,16079.0,635,441,28392.000000000004,5,2,3,10
2737,16080.0,1775,100,2171.6000000000004,4,1,1,6
2738,16081.0,29394,49729,624270.66,1,5,5,11
2739,16083.0,7520,961,40846.219999999994,3,3,3,9
2740,16084.0,11362,1444,16574.84,2,3,3,8
2741,16085.0,21757,27889,163912.17,1,5,4,10
2742,16086.0,7632,1521,43734.21000000001,3,3,3,9
2743,16091.0,3212,324,5671.08,4,2,2,8
2744,16092.0,10025,2601,41710.86,2,3,3,8
2745,16093.0,106,1,17.0,5,1,1,7
2746,16094.0,4633,3969,67928.48999999999,3,4,4,11
2747,16096.0,3168,144,3847.44,4,1,2,7
2748,16097.0,2400,100,1850.5,4,1,1,6
2749,16098.0,13603,4489,134377.21000000002,2,4,4,10
2750,16099.0,6406,1521,28544.09999999999,3,3,3,9
2751,16101.0,5320,5776,98093.19999999998,3,4,4,11
2752,16102.0,6068,3249,105001.98000000001,3,3,4,10
2753,16103.0,8157,2304,68622.72,2,3,4,9
2754,16104.0,1708,784,8349.880000000001,4,2,2,8
2755,16105.0,3224,169,4380.48,4,1,2,7
2756,16106.0,390,36,650.28,5,1,1,7
2757,16107.0,3332,961,99328.95999999999,4,3,4,11
2758,16108.0,4032,2304,40440.0,3,3,3,9
2759,16109.0,4194,324,11013.840000000002,3,2,2,7
2760,16110.0,61842,116964,451764.9000000002,1,5,5,11
2761,16112.0,4222,256,3131.84,3,2,1,6
2762,16113.0,5490,900,4841.4,3,3,2,8
2763,16114.0,1360,64,1086.0000000000002,4,1,1,6
2764,16115.0,40016,77841,463385.52,1,5,5,11
2765,16116.0,7174,1156,20834.520000000004,3,3,3,9
2766,16117.0,5670,900,6966.3,3,3,2,8
2767,16119.0,832,256,6773.76,5,2,2,9
2768,16120.0,1770,900,39274.200000000004,4,3,3,10
2769,16121.0,22846,41616,174350.63999999998,1,5,4,10
2770,16122.0,8698,1444,26007.96,2,3,3,8
2771,16123.0,816,256,4924.4800000000005,5,2,2,9
2772,16124.0,3487,121,2739.0,4,1,1,6
2773,16125.0,4771,169,3761.55,3,1,2,6
2774,16126.0,14599,13689,735669.0900000001,2,4,5,11
2775,16127.0,1560,1600,26250.0,4,3,3,10
2776,16128.0,11472,7921,167339.58000000002,2,4,4,10
2777,16131.0,11422,6084,273510.12000000005,2,4,5,11
2778,16133.0,43127,114921,4945684.5600000005,1,5,5,11
2779,16134.0,6143,1225,21633.15,3,3,3,9
2780,16135.0,5502,441,10868.550000000001,3,2,2,7
2781,16136.0,4053,1369,26247.06000000001,3,3,3,9
2782,16139.0,2532,961,19697.710000000003,4,3,3,10
2783,16140.0,4417,1225,25381.300000000003,3,3,3,9
2784,16141.0,2640,900,18612.0,4,3,3,10
2785,16142.0,9213,1369,19807.579999999998,2,3,3,8
2786,16143.0,24058,13689,283717.98,1,4,5,10
2787,16144.0,246,1,175.2,5,1,1,7
2788,16145.0,35871,50176,851085.76,1,5,5,11
2789,16146.0,6392,841,21289.769999999997,3,2,3,8
2790,16147.0,2926,484,8250.0,4,2,2,8
2791,16148.0,296,1,76.32000000000001,5,1,1,7
2792,16149.0,1590,324,5049.360000000001,4,2,2,8
2793,16150.0,22768,13689,240203.34,1,4,5,10
2794,16152.0,7772,841,53042.159999999996,3,2,4,9
2795,16153.0,12791,7921,162356.47,2,4,4,10
2796,16156.0,18483,16384,395781.12,2,5,5,12
2797,16157.0,668,324,11820.419999999998,5,2,2,9
2798,16159.0,3934,196,4874.800000000001,3,1,2,6
2799,16160.0,1600,400,20508.800000000003,4,2,3,9
2800,16161.0,84285,221841,2606358.57,1,5,5,11
2801,16162.0,504,4,74.8,5,1,1,7
2802,16163.0,2057,36,5139.6,4,1,2,7
2803,16164.0,984,1156,27964.32,5,3,3,11
2804,16168.0,14360,9604,371184.8,2,4,5,11
2805,16169.0,3496,7225,154952.45000000004,4,4,4,12
2806,16170.0,19387,15625,235631.25000000006,1,5,5,11
2807,16171.0,177,9,219.60000000000002,5,1,1,7
2808,16172.0,11036,4761,78674.49000000003,2,4,4,10
2809,16173.0,5247,7056,119138.87999999999,3,4,4,11
2810,16174.0,3364,529,23219.649999999998,4,2,3,9
2811,16175.0,10122,3364,60180.219999999994,2,4,4,10
2812,16177.0,750,225,4979.25,5,2,2,9
2813,16178.0,1104,64,1583.2,5,1,1,7
2814,16179.0,660,121,2374.13,5,1,1,7
2815,16180.0,28684,26244,1661177.1600000001,1,5,5,11
2816,16181.0,803,121,3360.940000000001,5,1,1,7
2817,16182.0,4096,784,185294.19999999998,3,2,4,9
2818,16183.0,1005,225,5080.6500000000015,5,2,2,9
2819,16184.0,6289,2025,52145.549999999996,3,3,4,10
2820,16185.0,4600,961,16411.710000000003,3,3,3,9
2821,16186.0,32866,47524,873512.9200000002,1,5,5,11
2822,16187.0,46828,87025,2038874.8,1,5,5,11
2823,16188.0,11451,4489,65784.62,2,4,4,10
2824,16189.0,585,121,2370.2799999999997,5,1,1,7
2825,16190.0,240,36,1290.48,5,1,1,7
2826,16191.0,18444,17956,694189.68,2,5,5,12
2827,16193.0,4484,361,5974.550000000001,3,2,2,7
2828,16198.0,1125,225,6010.215,5,2,2,9
2829,16200.0,9968,29584,183845.63999999998,2,5,4,11
2830,16201.0,4207,12321,206845.17000000004,3,4,4,11
2831,16202.0,6480,324,6574.86,3,2,2,7
2832,16203.0,7361,1225,20751.5,3,3,3,9
2833,16204.0,1150,2500,19209.0,5,3,3,11
2834,16205.0,8895,9409,73490.11,2,4,4,10
2835,16206.0,13671,3969,33834.780000000006,2,4,3,9
2836,16207.0,475,361,7493.22,5,2,2,9
2837,16208.0,12704,4356,43841.159999999996,2,4,3,9
2838,16209.0,7908,2116,104080.51999999997,3,3,4,10
2839,16210.0,21716,15129,2593614.9000000004,1,5,5,11
2840,16211.0,2024,529,12581.460000000003,4,2,2,8
2841,16212.0,8699,1681,28303.939999999995,2,3,3,8
2842,16213.0,468,36,954.0,5,1,1,7
2843,16214.0,10860,1936,46761.0,2,3,3,8
2844,16215.0,1120,196,3392.9,5,1,1,7
2845,16216.0,9879,1369,33852.409999999996,2,3,3,8
2846,16217.0,4042,225,4563.750000000001,3,2,2,7
2847,16218.0,18728,7056,259113.12,2,4,5,11
2848,16221.0,12172,9025,81781.7,2,4,4,10
2849,16222.0,38796,14884,94373.1,1,5,4,10
2850,16224.0,15498,9216,124348.79999999999,2,4,4,10
2851,16225.0,27748,17956,146906.88000000003,1,5,4,10
2852,16226.0,1736,64,2040.96,4,1,1,6
2853,16227.0,1350,36,1885.3200000000002,4,1,1,6
2854,16229.0,5589,2209,47498.19999999999,3,3,3,9
2855,16230.0,7204,1225,18971.05,3,3,3,9
2856,16232.0,6059,1369,36662.56,3,3,3,9
2857,16233.0,3958,484,11806.96,3,2,2,7
2858,16235.0,9467,2116,39896.259999999995,2,3,3,8
2859,16236.0,1560,400,8643.999999999998,4,2,2,8
2860,16239.0,3059,361,7869.8,4,2,2,8
2861,16240.0,7215,18225,502038.0,3,5,5,13
2862,16241.0,95277,429025,1696653.0500000003,1,5,5,11
2863,16242.0,24489,85264,1045319.12,1,5,5,11
2864,16243.0,2040,2601,20864.100000000002,4,3,3,10
2865,16244.0,29344,8281,138570.25,1,4,4,9
2866,16245.0,11118,8100,127229.40000000001,2,4,4,10
2867,16247.0,2720,256,1832.96,4,2,1,7
2868,16248.0,427,49,1070.58,5,1,1,7
2869,16249.0,10217,4761,124204.83000000002,2,4,4,10
2870,16250.0,7832,576,9346.56,3,2,2,7
2871,16253.0,18135,15129,453114.78,2,5,5,12
2872,16255.0,50923,72900,707375.7,1,5,5,11
2873,16256.0,3458,169,9781.590000000002,4,1,2,7
2874,16257.0,352,4,93.9,5,1,1,7
2875,16258.0,17718,18225,702473.8500000002,2,5,5,12
2876,16260.0,900,324,18638.100000000002,5,2,3,10
2877,16261.0,17547,14161,86696.26000000001,2,4,4,10
2878,16265.0,52856,66564,1405326.0,1,5,5,11
2879,16266.0,9568,3721,52575.28999999999,2,4,4,10
2880,16268.0,3195,2025,30044.250000000004,4,3,3,10
2881,16270.0,19062,2916,61626.95999999998,1,3,4,8
2882,16271.0,14662,16900,182603.2,2,5,4,11
2883,16272.0,2900,625,10292.5,4,2,2,8
2884,16274.0,24245,4225,22863.75,1,4,3,8
2885,16275.0,6468,1089,18475.71,3,3,3,9
2886,16276.0,1056,36,4863.6,5,1,2,8
2887,16278.0,2300,529,13026.74,4,2,2,8
2888,16279.0,7742,11236,159294.68,3,4,4,11
2889,16281.0,1224,289,35055.020000000004,5,2,3,10
2890,16282.0,3729,121,1851.3000000000002,3,1,1,5
2891,16283.0,18225,27556,260754.46,2,5,5,12
2892,16284.0,4124,10609,83706.04,3,4,4,11
2893,16287.0,1352,64,1140.0,4,1,1,6
2894,16292.0,2057,289,5138.25,4,2,2,8
2895,16293.0,19396,13924,265380.81999999995,1,4,5,10
2896,16295.0,3235,6241,104955.45000000003,4,4,4,12
2897,16297.0,5360,400,6038.000000000001,3,2,2,7
2898,16298.0,2119,729,16151.399999999998,4,2,3,9
2899,16302.0,1386,121,2565.42,4,1,1,6
2900,16303.0,23290,26244,868422.0600000002,1,5,5,11
2901,16305.0,3036,484,7946.839999999998,4,2,2,8
2902,16306.0,12655,1681,25923.07,2,3,3,8
2903,16308.0,622,16,10240.0,5,1,2,8
2904,16309.0,7266,1764,29675.940000000002,3,3,3,9
2905,16311.0,1365,1369,22801.62,4,3,3,10
2906,16313.0,508,256,4386.400000000001,5,2,2,9
2907,16315.0,4620,196,3169.1800000000003,3,1,1,5
2908,16316.0,29741,22801,443775.41,1,5,5,11
2909,16317.0,14559,4761,92573.85,2,4,4,10
2910,16318.0,665,361,6234.849999999999,5,2,2,9
2911,16319.0,651,9,1213.1999999999998,5,1,1,7
2912,16320.0,11559,3136,58153.76,2,3,4,9
2913,16321.0,2800,144,4483.799999999999,4,1,2,7
2914,16322.0,1017,1369,12089.749999999998,5,3,2,10
2915,16323.0,196,1,207.50000000000003,5,1,1,7
2916,16324.0,16511,12321,45353.48999999999,2,4,3,9
2917,16325.0,2695,324,10696.32,4,2,2,8
2918,16326.0,35821,90000,911766.0000000001,1,5,5,11
2919,16327.0,64744,100489,1211025.59,1,5,5,11
2920,16330.0,2278,1521,9824.49,4,3,2,9
2921,16332.0,14682,22801,239002.8,2,5,5,12
2922,16333.0,8951,2025,1198206.0,2,3,5,10
2923,16337.0,360,100,1510.5,5,1,1,7
2924,16338.0,1727,121,2362.8,4,1,1,6
2925,16339.0,5112,324,1692.8999999999999,3,2,1,6
2926,16340.0,15087,19881,75337.70999999999,2,5,4,11
2927,16341.0,9055,5929,151833.99,2,4,4,10
2928,16342.0,2197,225,4836.150000000001,4,2,2,8
2929,16343.0,688,1849,14128.940000000002,5,3,2,10
2930,16344.0,316,4,202.2,5,1,1,7
2931,16345.0,1628,1369,20922.02,4,3,3,10
2932,16347.0,2210,7225,72033.25,4,4,4,12
2933,16348.0,33782,49284,314274.30000000005,1,5,5,11
2934,16349.0,2610,81,481.5,4,1,1,6
2935,16350.0,9604,3249,63638.79,2,3,4,9
2936,16351.0,2656,64,1231.2,4,1,1,6
2937,16352.0,756,784,13844.32,5,2,2,9
2938,16353.0,15089,8836,627516.7400000001,2,4,5,11
2939,16354.0,2837,1521,15436.2,4,3,3,10
2940,16356.0,7337,961,6564.87,3,3,2,8
2941,16357.0,3027,1156,22401.92,4,3,3,10
2942,16358.0,7711,11881,220997.5,3,4,4,11
2943,16359.0,13527,4356,115560.72000000002,2,4,4,10
2944,16360.0,24179,404496,2194460.76,1,5,5,11
2945,16361.0,4550,10816,92685.84,3,4,4,11
2946,16362.0,5386,5929,54669.23,3,4,4,11
2947,16363.0,265,25,546.8,5,1,1,7
2948,16364.0,4100,2704,36701.079999999994,3,3,3,9
2949,16365.0,7540,2601,78561.42,3,3,4,10
2950,16366.0,324,324,5891.400000000001,5,2,2,9
2951,16367.0,15749,16129,101685.08999999995,2,5,4,11
2952,16368.0,814,4761,33113.79,5,4,3,12
2953,16369.0,7814,13689,180812.97000000003,3,4,4,11
2954,16370.0,33825,48841,287722.11000000004,1,5,5,11
2955,16372.0,3036,8464,32727.160000000003,4,4,3,11
2956,16374.0,12290,11881,50873.57,2,4,3,9
2957,16376.0,1903,14884,118945.12000000001,4,5,4,13
2958,16377.0,1335,25,3381.0,4,1,1,6
2959,16378.0,6801,529,8347.850000000002,3,2,2,7
2960,16379.0,4124,11664,232999.20000000007,3,4,5,12
2961,16380.0,1891,961,54037.65,4,3,4,11
2962,16383.0,17534,9604,63088.47999999999,2,4,4,10
2963,16384.0,7113,1089,19288.5,3,3,3,9
2964,16385.0,10998,3249,31627.019999999993,2,3,3,8
2965,16386.0,3168,6561,24508.169999999995,4,4,3,11
2966,16387.0,1288,16,377.44,5,1,1,7
2967,16389.0,4877,1156,46990.37999999999,3,3,3,9
2968,16392.0,11567,1849,9369.269999999999,2,3,2,7
2969,16393.0,46089,106929,994393.92,1,5,5,11
2970,16394.0,16640,6889,129093.21999999999,2,4,4,10
2971,16395.0,34421,42436,305304.36000000004,1,5,5,11
2972,16398.0,18865,6724,139875.6,1,4,4,9
2973,16399.0,8064,5184,29377.44,2,4,3,9
2974,16400.0,2726,841,8813.97,4,2,2,8
2975,16401.0,25025,34596,762287.5199999999,1,5,5,11
2976,16402.0,20718,3249,16726.649999999998,1,3,3,7
2977,16403.0,3120,100,1775.0,4,1,1,6
2978,16404.0,1610,529,10190.150000000001,4,2,2,8
2979,16405.0,1534,25,836.25,4,1,1,6
2980,16406.0,1062,3481,9106.650000000001,5,4,2,11
2981,16407.0,25748,28224,349386.24000000005,1,5,5,11
2982,16409.0,41867,53361,467308.38,1,5,5,11
2983,16411.0,7836,1936,9314.8,3,3,2,8
2984,16412.0,1590,900,4079.7000000000003,4,3,2,9
2985,16413.0,1736,961,8128.2,4,3,2,9
2986,16414.0,924,49,883.75,5,1,1,7
2987,16415.0,2068,2209,9412.689999999999,4,3,2,9
2988,16416.0,3168,5041,74649.40000000001,4,4,4,12
2989,16418.0,9040,9025,59956.40000000001,2,4,4,10
2990,16419.0,10860,2500,47935.5,2,3,3,8
2991,16422.0,70325,136161,12798543.6,1,5,5,11
2992,16423.0,432,324,6230.16,5,2,2,9
2993,16424.0,955,25,667.8,5,1,1,7
2994,16425.0,6342,441,6356.699999999999,3,2,2,7
2995,16426.0,15670,124609,657907.28,2,5,5,12
2996,16427.0,2451,81,2169.54,4,1,1,6
2997,16429.0,212,4,569.1,5,1,1,7
2998,16430.0,342,36,1805.1000000000001,5,1,1,7
2999,16431.0,19968,5776,47369.27999999999,1,4,3,8
3000,16432.0,512,64,2299.2,5,1,1,7
3001,16433.0,476,289,3132.42,5,2,1,8
3002,16434.0,13902,11449,161762.6,2,4,4,10
3003,16438.0,5780,17424,105382.2,3,5,4,12
3004,16440.0,16245,79524,1026668.9400000001,2,5,5,12
3005,16441.0,4520,576,9148.8,3,2,2,7
3006,16442.0,28623,29241,104190.29999999999,1,5,4,10
3007,16444.0,13569,7056,54992.280000000006,2,4,4,10
3008,16445.0,2079,3969,14522.13,4,4,3,11
3009,16446.0,410,9,505417.5,5,1,5,11
3010,16447.0,4590,1156,8700.94,3,3,2,8
3011,16448.0,3762,361,3476.8100000000004,3,2,1,6
3012,16449.0,9789,1600,28307.600000000002,2,3,3,8
3013,16450.0,1639,121,3431.1200000000003,4,1,1,6
3014,16451.0,1218,196,3737.5800000000004,5,1,1,7
3015,16454.0,108,4,13.8,5,1,1,7
3016,16455.0,20797,9801,182276.82,1,4,4,9
3017,16456.0,27589,12100,237399.80000000005,1,4,5,10
3018,16457.0,1962,81,1875.2400000000002,4,1,1,6
3019,16458.0,31058,40804,703513.4800000001,1,5,5,11
3020,16460.0,8990,17424,107082.36,2,5,4,11
3021,16461.0,5664,1024,4573.44,3,3,2,8
3022,16462.0,541,9,408.0,5,1,1,7
3023,16463.0,6492,6724,116636.8,3,4,4,11
3024,16464.0,20811,52900,298691.80000000005,1,5,5,11
3025,16466.0,18041,21316,233010.16,2,5,5,12
3026,16468.0,148,4,149.8,5,1,1,7
3027,16469.0,21595,29241,106946.82,1,5,4,10
3028,16470.0,25461,26896,123454.28,1,5,4,10
3029,16471.0,3562,169,2911.35,4,1,1,6
3030,16473.0,4943,324,5689.9800000000005,3,2,2,7
3031,16474.0,25262,113569,610189.05,1,5,5,11
3032,16475.0,6606,784,15240.399999999998,3,2,3,8
3033,16477.0,33807,21316,364191.16000000003,1,5,5,11
3034,16478.0,904,289,5627.0,5,2,2,9
3035,16479.0,350,1225,10529.05,5,3,2,10
3036,16480.0,3975,2809,40772.369999999995,3,3,3,9
3037,16482.0,270,324,3971.16,5,2,2,9
3038,16483.0,3648,361,2647.65,4,2,1,7
3039,16484.0,4631,625,10107.500000000002,3,2,2,7
3040,16485.0,3234,1764,15273.3,4,3,3,10
3041,16488.0,3113,841,14465.2,4,2,2,8
3042,16491.0,1794,1521,28528.5,4,3,3,10
3043,16493.0,9452,3136,75691.28,2,3,4,9
3044,16494.0,14800,2500,41326.49999999999,2,3,3,8
3045,16495.0,9273,7744,57046.88,2,4,4,10
3046,16496.0,19358,9025,151954.4,1,4,4,9
3047,16497.0,23847,18496,403333.84,1,5,5,11
3048,16498.0,2429,225,1514.55,4,2,1,7
3049,16499.0,6880,361,6943.550000000002,3,2,2,7
3050,16500.0,541,121,4409.46,5,1,2,8
3051,16503.0,22956,7056,120282.11999999998,1,4,4,9
3052,16504.0,2075,6889,38668.04,4,4,3,11
3053,16505.0,124,16,3110.4,5,1,1,7
3054,16506.0,99,9,270.9,5,1,1,7
3055,16509.0,3848,169,4728.100000000001,3,1,2,6
3056,16510.0,4836,169,3225.2999999999997,3,1,1,5
3057,16511.0,22346,25281,146014.47,1,5,4,10
3058,16513.0,672,1225,30610.649999999998,5,3,3,11
3059,16515.0,20355,12321,180279.54,1,4,4,9
3060,16516.0,180,36,610.2,5,1,1,7
3061,16517.0,4709,289,2765.9000000000005,3,2,1,6
3062,16518.0,4893,1600,19372.800000000003,3,3,3,9
3063,16519.0,2025,169,2796.04,4,1,1,6
3064,16520.0,42618,24336,163264.91999999998,1,5,4,10
3065,16523.0,40831,84100,2731356.3,1,5,5,11
3066,16525.0,35893,33489,2384023.35,1,5,5,11
3067,16526.0,2565,225,4355.400000000001,4,2,2,8
3068,16527.0,1134,196,3192.8400000000006,5,1,1,7
3069,16528.0,51,289,4154.970000000001,5,2,2,9
3070,16529.0,5700,900,13657.5,3,3,2,8
3071,16531.0,13003,5929,95833.43,2,4,4,10
3072,16532.0,625,16,26995.2,5,1,3,9
3073,16533.0,9245,30976,190574.56,2,5,4,11
3074,16535.0,155,961,18406.25,5,3,3,11
3075,16536.0,5940,2916,29598.48,3,3,3,9
3076,16539.0,12821,2025,62496.45,2,3,4,9
3077,16542.0,265,25,598.1,5,1,1,7
3078,16545.0,492,9,1017.9000000000001,5,1,1,7
3079,16546.0,7742,625,19678.75,3,2,3,8
3080,16549.0,49262,855625,3732282.5,1,5,5,11
3081,16550.0,53560,63001,577041.47,1,5,5,11
3082,16551.0,6076,1024,29507.84,3,3,3,9
3083,16552.0,4769,289,6455.41,3,2,2,7
3084,16553.0,22228,7056,480464.88,1,4,5,10
3085,16554.0,6073,2704,43529.2,3,3,3,9
3086,16555.0,1261,289,4860.13,5,2,2,9
3087,16556.0,38821,42849,685954.53,1,5,5,11
3088,16557.0,942,121,3100.3500000000004,5,1,1,7
3089,16558.0,74349,211600,3835705.400000001,1,5,5,11
3090,16560.0,8454,3249,47960.37,2,3,3,8
3091,16561.0,1019,961,15844.72,5,3,3,11
3092,16563.0,1007,361,20477.06,5,2,3,10
3093,16565.0,1092,9,521.0999999999999,5,1,1,7
3094,16566.0,2079,324,11063.880000000001,4,2,2,8
3095,16567.0,10482,1225,30296.0,2,3,3,8
3096,16569.0,15,25,621.0,5,1,1,7
3097,16570.0,19364,15876,471038.4,1,5,5,11
3098,16571.0,14157,7569,123687.03,2,4,4,10
3099,16572.0,10755,3249,57547.200000000004,2,3,4,9
3100,16573.0,6824,1764,27871.62,3,3,3,9
3101,16574.0,1988,784,12640.32,4,2,2,8
3102,16581.0,1638,81,952.5600000000001,4,1,1,6
3103,16582.0,678,36,1881.7199999999998,5,1,1,7
3104,16583.0,5222,196,3268.2999999999997,3,1,1,5
3105,16584.0,4676,784,26210.239999999994,3,2,3,8
3106,16586.0,1984,64,3711.6,4,1,1,6
3107,16587.0,3016,169,2926.9499999999994,4,1,1,6
3108,16589.0,3363,1089,15154.92,4,3,3,10
3109,16591.0,680,100,2135.0,5,1,1,7
3110,16592.0,27496,46656,888554.8800000001,1,5,5,11
3111,16593.0,4407,729,8910.810000000001,3,2,2,7
3112,16594.0,3975,2809,9597.77,3,3,2,8
3113,16595.0,5185,7225,30613.600000000002,3,4,3,10
3114,16596.0,2286,144,3001.8,4,1,1,6
3115,16597.0,28,49,630.2800000000002,5,1,1,7
3116,16598.0,2850,100,1450.5,4,1,1,6
3117,16600.0,6451,3844,50438.23999999999,3,4,3,10
3118,16601.0,1200,900,7281.0,5,3,2,10
3119,16602.0,1044,841,15314.319999999998,5,2,3,10
3120,16603.0,2907,1156,16403.98,4,3,3,10
3121,16607.0,27681,29584,575806.12,1,5,5,11
3122,16609.0,37263,76176,1516194.96,1,5,5,11
3123,16610.0,1314,36,453.96,5,1,1,7
3124,16611.0,1860,100,1294.9,4,1,1,6
3125,16612.0,11613,4356,78385.56000000001,2,4,4,10
3126,16613.0,2100,900,18557.700000000004,4,3,3,10
3127,16614.0,4732,676,13160.94,3,2,2,7
3128,16616.0,2057,1089,16513.86,4,3,3,10
3129,16617.0,1175,25,759.2500000000001,5,1,1,7
3130,16618.0,17003,9216,254168.64,2,4,5,11
3131,16619.0,3682,196,3166.94,3,1,1,5
3132,16620.0,1312,81,1610.64,5,1,1,7
3133,16621.0,5057,841,23590.920000000006,3,2,3,8
3134,16623.0,1225,25,647.25,5,1,1,7
3135,16624.0,6297,2304,38907.36,3,3,3,9
3136,16625.0,6302,529,7660.839999999999,3,2,2,7
3137,16626.0,24574,32041,789944.9,1,5,5,11
3138,16627.0,1580,400,6456.000000000002,4,2,2,8
3139,16628.0,15438,13689,256001.85000000003,2,4,5,11
3140,16629.0,5438,3600,24517.8,3,4,3,10
3141,16633.0,14471,23104,438231.20000000007,2,5,5,12
3142,16634.0,3198,81,1961.1000000000001,4,1,1,6
3143,16637.0,7312,4761,79658.43000000004,3,4,4,11
3144,16638.0,20739,8836,157987.68,1,4,4,9
3145,16639.0,5456,2500,62875.5,3,3,4,10
3146,16641.0,1260,144,2773.2,5,1,1,7
3147,16642.0,3181,1156,23403.22,4,3,3,10
3148,16643.0,6615,729,13162.77,3,2,2,7
3149,16644.0,12864,3844,51694.36,2,4,4,10
3150,16647.0,2681,196,2996.84,4,1,1,6
3151,16648.0,798,361,5522.540000000001,5,2,2,9
3152,16650.0,1704,576,12442.080000000002,4,2,2,8
3153,16652.0,17032,13924,799328.4600000001,2,4,5,11
3154,16653.0,4789,4761,83673.54000000002,3,4,4,11
3155,16654.0,7494,841,17436.829999999994,3,2,3,8
3156,16655.0,34220,66564,977696.16,1,5,5,11
3157,16656.0,12388,5329,629683.4,2,4,5,11
3158,16657.0,26492,36864,167890.56,1,5,4,10
3159,16658.0,2944,64,985.92,4,1,1,6
3160,16659.0,378,4,78.24,5,1,1,7
3161,16660.0,1662,256,20282.4,4,2,3,9
3162,16665.0,3258,81,1218.6,4,1,1,6
3163,16666.0,608,1024,3807.36,5,3,2,10
3164,16667.0,7856,2704,29493.359999999997,3,3,3,9
3165,16668.0,3231,400,6134.400000000001,4,2,2,8
3166,16669.0,7823,24336,210425.28000000003,3,5,4,12
3167,16670.0,50035,63504,1032166.8,1,5,5,11
3168,16671.0,590,36,10153.619999999999,5,1,2,8
3169,16672.0,20505,12996,927383.1599999999,1,4,5,10
3170,16674.0,6474,8649,28294.32,3,4,3,10
3171,16676.0,18433,7921,141698.68,2,4,4,10
3172,16678.0,23226,26569,506928.36999999994,1,5,5,11
3173,16679.0,1098,9,389.25,5,1,1,7
3174,16680.0,430,100,1837.0,5,1,1,7
3175,16681.0,7938,1936,77894.95999999999,2,3,4,9
3176,16682.0,3401,900,30839.999999999993,4,3,3,10
3177,16684.0,45317,76729,18463036.12,1,5,5,11
3178,16685.0,3782,3844,20102.88,3,4,3,10
3179,16686.0,96541,295936,1610174.72,1,5,5,11
3180,16688.0,2205,3844,78173.31999999999,4,4,4,12
3181,16689.0,1045,169,5493.8,5,1,2,8
3182,16690.0,1509,144,2706.96,4,1,1,6
3183,16692.0,801,9,3828.0,5,1,2,8
3184,16693.0,8275,3481,28193.74,2,4,3,9
3185,16696.0,2112,100,6579.000000000001,4,1,2,7
3186,16697.0,5061,441,2367.75,3,2,1,6
3187,16698.0,1238,25,9990.0,5,1,2,8
3188,16700.0,62231,94864,1563577.4000000004,1,5,5,11
3189,16701.0,24394,20736,777355.2,1,5,5,11
3190,16705.0,40908,72900,3789447.3000000003,1,5,5,11
3191,16706.0,12015,15129,65356.04999999999,2,5,4,11
3192,16708.0,1215,729,17729.010000000002,5,2,3,10
3193,16709.0,15112,6241,239359.73000000004,2,4,5,11
3194,16710.0,79742,155236,972388.0599999999,1,5,5,11
3195,16711.0,2138,484,36322.659999999996,4,2,3,9
3196,16712.0,60865,191844,1581753.78,1,5,5,11
3197,16713.0,105326,383161,4277772.82,1,5,5,11
3198,16714.0,27480,7569,98228.22,1,4,4,9
3199,16715.0,1482,361,5732.68,4,2,2,8
3200,16716.0,577,4,1802.4,5,1,1,7
3201,16717.0,18715,39204,760929.84,2,5,5,12
3202,16718.0,16236,1936,26666.200000000004,2,3,3,8
3203,16719.0,40165,38416,346963.12,1,5,5,11
3204,16720.0,650,625,3823.7499999999995,5,2,2,9
3205,16721.0,9694,1369,10821.390000000001,2,3,2,7
3206,16722.0,39804,50625,1064432.25,1,5,5,11
3207,16723.0,4478,1764,24208.8,3,3,3,9
3208,16725.0,49213,21025,109949.15,1,5,4,10
3209,16726.0,30984,31684,241855.72000000003,1,5,5,11
3210,16727.0,16016,1936,11278.079999999998,2,3,2,7
3211,16728.0,37538,69169,275697.64,1,5,5,11
3212,16729.0,93286,430336,4726696.4799999995,1,5,5,11
3213,16730.0,12188,6724,60935.020000000004,2,4,4,10
3214,16732.0,868,784,16904.999999999996,5,2,3,10
3215,16734.0,4688,2704,33631.52,3,3,3,9
3216,16735.0,22957,13456,260699.56000000003,1,4,5,10
3217,16737.0,53,1,417.6,5,1,1,7
3218,16738.0,297,1,3.75,5,1,1,7
3219,16739.0,2288,169,4199.000000000001,4,1,2,7
3220,16742.0,46,1,464.9,5,1,1,7
3221,16743.0,36065,36100,420494.7,1,5,5,11
3222,16744.0,18357,55696,304890.76,2,5,5,12
3223,16745.0,78272,126025,2549148.5,1,5,5,11
3224,16746.0,76501,197136,2965968.8400000003,1,5,5,11
3225,16747.0,2364,1764,35114.52,4,3,3,10
3226,16748.0,10416,4761,104597.1,2,4,4,10
3227,16750.0,9882,9025,59273.350000000006,2,4,4,10
3228,16751.0,750,625,44117.99999999999,5,2,3,10
3229,16752.0,3348,81,1867.5,4,1,1,6
3230,16753.0,1972,1156,7613.28,4,3,2,9
3231,16754.0,744,4,4004.8,5,1,2,8
3232,16755.0,29530,27225,243445.94999999998,1,5,5,11
3233,16756.0,2782,169,3112.2000000000003,4,1,1,6
3234,16757.0,2226,49,747.81,4,1,1,6
3235,16758.0,1430,484,8125.48,4,2,2,8
3236,16759.0,823,1764,33171.18,5,3,3,11
3237,16761.0,1248,169,4116.06,5,1,2,8
3238,16762.0,3368,3969,76056.12,4,4,4,12
3239,16763.0,4554,529,14072.550000000003,3,2,2,7
3240,16764.0,42364,490000,1953665.0000000002,1,5,5,11
3241,16765.0,294,1,34.0,5,1,1,7
3242,16766.0,9282,1156,38950.39999999999,2,3,3,8
3243,16767.0,38667,48841,1232198.76,1,5,5,11
3244,16768.0,8810,2916,25816.859999999997,2,3,3,8
3245,16769.0,9880,1444,13738.519999999997,2,3,2,7
3246,16770.0,31432,19600,105993.99999999999,1,5,4,10
3247,16771.0,58012,64516,569622.9400000001,1,5,5,11
3248,16773.0,1482,676,4461.34,4,2,2,8
3249,16774.0,5902,2304,31752.96,3,3,3,9
3250,16775.0,25848,24649,265567.07,1,5,5,11
3251,16776.0,4260,5041,26379.34,3,4,3,10
3252,16777.0,10389,2304,10685.76,2,3,2,7
3253,16778.0,2184,256,3935.04,4,2,2,8
3254,16779.0,59558,109561,3512479.32,1,5,5,11
3255,16780.0,8285,3481,24912.16,2,4,3,9
3256,16781.0,6324,289,5291.25,3,2,2,7
3257,16782.0,48381,33489,415034.85,1,5,5,11
3258,16784.0,57,9,322.79999999999995,5,1,1,7
3259,16788.0,26326,21904,87969.71999999999,1,5,4,10
3260,16789.0,40,25,404.0,5,1,1,7
3261,16790.0,2744,8649,143742.66,4,4,4,12
3262,16791.0,42557,98596,535614.9199999998,1,5,5,11
3263,16792.0,3384,144,1324.56,4,1,1,6
3264,16793.0,912,256,3901.44,5,2,2,9
3265,16794.0,27025,77284,332627.0,1,5,5,11
3266,16795.0,24090,4356,27382.079999999998,1,4,3,8
3267,16796.0,1602,324,5501.159999999999,4,2,2,8
3268,16800.0,1716,24336,181373.40000000002,4,5,4,13
3269,16801.0,18082,5625,119567.25,2,4,4,10
3270,16803.0,1560,576,7975.200000000001,4,2,2,8
3271,16804.0,6073,3600,32219.4,3,4,3,10
3272,16805.0,27239,9604,45137.81999999999,1,4,3,8
3273,16806.0,15102,8649,70880.88,2,4,4,10
3274,16807.0,13425,4489,75146.53,2,4,4,10
3275,16808.0,5602,529,6633.660000000001,3,2,2,7
3276,16809.0,21672,22201,136288.81,1,5,4,10
3277,16810.0,2880,225,4643.1,4,2,2,8
3278,16811.0,346,784,15317.96,5,2,3,10
3279,16812.0,5400,225,7190.250000000001,3,2,2,7
3280,16813.0,57390,181476,703828.68,1,5,5,11
3281,16814.0,68979,101761,2046927.3000000003,1,5,5,11
3282,16816.0,7539,784,11677.680000000002,3,2,2,7
3283,16817.0,16134,7396,138008.5,2,4,4,10
3284,16818.0,25659,35721,633068.73,1,5,5,11
3285,16820.0,2470,676,12937.86,4,2,2,8
3286,16823.0,8626,1444,13618.439999999997,2,3,2,7
3287,16824.0,2327,676,11976.64,4,2,2,8
3288,16825.0,2681,784,21705.04,4,2,3,9
3289,16826.0,1122,484,7517.4000000000015,5,2,2,9
3290,16828.0,877,64,1028.0,5,1,1,7
3291,16829.0,1716,121,2169.42,4,1,1,6
3292,16830.0,874,529,7495.93,5,2,2,9
3293,16832.0,2501,144,2389.8,4,1,1,6
3294,16833.0,9653,2209,52006.909999999996,2,3,4,9
3295,16834.0,5448,576,9923.039999999999,3,2,2,7
3296,16835.0,2505,100,1808.5,4,1,1,6
3297,16836.0,583,121,2770.57,5,1,1,7
3298,16837.0,22116,27225,523211.7,1,5,5,11
3299,16838.0,6199,625,14721.25,3,2,3,8
3300,16839.0,45825,70756,4414097.1,1,5,5,11
3301,16841.0,20205,13456,216899.12,1,4,4,9
3302,16842.0,13240,3969,79643.97,2,4,4,10
3303,16843.0,59910,142884,3854303.4600000004,1,5,5,11
3304,16846.0,550,121,2357.52,5,1,1,7
3305,16847.0,516,144,2321.2799999999997,5,1,1,7
3306,16848.0,728,196,3939.88,5,1,2,8
3307,16849.0,1488,64,996.56,4,1,1,6
3308,16850.0,6327,361,6315.790000000001,3,2,2,7
3309,16851.0,675,400,6849.000000000001,5,2,2,9
3310,16852.0,1252,81,1304.19,5,1,1,7
3311,16855.0,617,361,6239.6,5,2,2,9
3312,16856.0,28,4,70.80000000000001,5,1,1,7
3313,16858.0,3680,100,3756.9000000000005,3,1,2,6
3314,16859.0,9594,2704,38886.12,2,3,3,8
3315,16861.0,552,36,1042.56,5,1,1,7
3316,16863.0,3821,676,13072.800000000001,3,2,2,7
3317,16866.0,1657,121,2285.1400000000003,4,1,1,6
3318,16869.0,12494,16129,103774.24000000002,2,5,4,11
3319,16871.0,26835,18769,385290.58,1,5,5,11
3320,16872.0,888,49,4760.139999999999,5,1,2,8
3321,16873.0,43971,77841,1987489.9800000002,1,5,5,11
3322,16875.0,19985,12544,234699.36000000002,1,4,5,10
3323,16877.0,11945,24336,132072.72,2,5,4,11
3324,16878.0,252,9,39.900000000000006,5,1,1,7
3325,16880.0,21993,30276,259508.82,1,5,5,11
3326,16881.0,66,1,432.0,5,1,1,7
3327,16882.0,5247,1521,27499.68,3,3,3,9
3328,16883.0,10047,1369,10081.76,2,3,2,7
3329,16884.0,962,676,11175.84,5,2,2,9
3330,16885.0,12060,9216,43239.36000000001,2,4,3,9
3331,16887.0,1260,1296,6923.88,5,3,2,10
3332,16889.0,35799,18225,213120.45,1,5,4,10
3333,16891.0,32006,34596,138091.98,1,5,4,10
3334,16892.0,4759,9409,50264.43000000001,3,4,3,10
3335,16893.0,16470,2025,6566.85,2,3,2,7
3336,16895.0,3968,3844,12540.74,3,4,2,9
3337,16897.0,11483,1369,10721.859999999999,2,3,2,7
3338,16898.0,24570,24649,78661.70999999999,1,5,4,10
3339,16899.0,16415,15129,156340.38,2,5,4,11
3340,16900.0,4531,6241,70081.69,3,4,4,11
3341,16902.0,5104,1936,75102.72,3,3,4,10
3342,16903.0,1624,3136,20339.2,4,3,3,10
3343,16904.0,113786,442225,2429743.7500000005,1,5,5,11
3344,16905.0,19243,39601,604482.4,1,5,5,11
3345,16906.0,12839,7396,48124.74000000002,2,4,3,9
3346,16907.0,30632,19600,130026.4,1,5,4,10
3347,16909.0,1296,324,6824.5199999999995,5,2,2,9
3348,16910.0,29397,297025,822383.2,1,5,5,11
3349,16912.0,17087,10000,255558.00000000003,2,4,5,11
3350,16913.0,2320,64,907.52,4,1,1,6
3351,16914.0,1080,900,5512.799999999999,5,3,2,10
3352,16915.0,8175,3249,35435.76,2,3,3,8
3353,16916.0,20229,18496,76487.76,1,5,4,10
3354,16917.0,2484,81,3523.68,4,1,1,6
3355,16918.0,19462,16384,136808.96000000002,1,5,4,10
3356,16919.0,77702,106276,845073.5,1,5,5,11
3357,16921.0,3355,3025,8479.9,4,3,2,9
3358,16923.0,102393,391876,4425244.08,1,5,5,11
3359,16924.0,4245,6561,67221.09000000001,3,4,4,11
3360,16926.0,5194,196,3223.5000000000005,3,1,1,5
3361,16927.0,1665,36,3258.3,4,1,1,6
3362,16928.0,35387,41616,574198.7999999999,1,5,5,11
3363,16929.0,5113,5929,99745.03000000001,3,4,4,11
3364,16930.0,2638,2809,20081.17,4,3,3,10
3365,16931.0,148734,784996,4035614.8200000008,1,5,5,11
3366,16932.0,2544,2304,7211.039999999999,4,3,2,9
3367,16933.0,4804,1936,24782.120000000003,3,3,3,9
3368,16934.0,3294,3721,56792.83000000001,4,4,4,12
3369,16936.0,1400,3136,14666.400000000001,4,3,3,10
3370,16938.0,40479,55225,637244.8,1,5,5,11
3371,16940.0,47582,93025,930213.4,1,5,5,11
3372,16942.0,38039,76729,527682.23,1,5,5,11
3373,16943.0,9560,1089,26952.089999999997,2,3,3,8
3374,16945.0,42584,62001,1082029.5,1,5,5,11
3375,16947.0,4935,441,8536.08,3,2,2,7
3376,16948.0,4172,361,8265.38,3,2,2,7
3377,16949.0,8321,3600,77176.20000000001,2,4,4,10
3378,16950.0,4917,1764,49499.52,3,3,3,9
3379,16951.0,23454,7396,109886.50000000001,1,4,4,9
3380,16952.0,1744,256,2681.76,4,2,1,7
3381,16953.0,30,1,20.8,5,1,1,7
3382,16954.0,11125,2916,112594.31999999999,2,3,4,9
3383,16955.0,7134,625,12966.749999999998,3,2,2,7
3384,16956.0,272,256,4939.84,5,2,2,9
3385,16957.0,3992,256,6666.24,3,2,2,7
3386,16959.0,609,49,821.4499999999999,5,1,1,7
3387,16960.0,14216,10201,51212.05,2,4,4,10
3388,16961.0,1624,196,3278.3799999999997,4,1,1,6
3389,16963.0,1309,49,773.85,5,1,1,7
3390,16965.0,5876,676,5230.94,3,2,2,7
3391,16966.0,4764,784,60339.16,3,2,4,9
3392,16967.0,3969,441,6699.42,3,2,2,7
3393,16968.0,1669,961,13622.33,4,3,2,9
3394,16969.0,6217,1764,27317.220000000005,3,3,3,9
3395,16971.0,1558,1681,14645.609999999999,4,3,3,10
3396,16976.0,534,4,503.04,5,1,1,7
3397,16978.0,3003,1521,13428.869999999997,4,3,2,9
3398,16979.0,6023,7921,164828.0,3,4,4,11
3399,16980.0,23247,6561,83305.26000000001,1,4,4,9
3400,16982.0,1320,484,8449.32,5,2,2,9
3401,16983.0,21169,20449,272539.41,1,5,5,11
3402,16984.0,46708,160000,1783808.0000000002,1,5,5,11
3403,16985.0,22007,14400,655694.3999999999,1,4,5,10
3404,16986.0,89,9,5619.6,5,1,2,8
3405,16987.0,11225,16384,206950.40000000002,2,5,4,11
3406,16988.0,35,49,882.84,5,1,1,7
3407,16989.0,1312,144,13599.0,5,1,2,8
3408,16990.0,218,1,179.0,5,1,1,7
3409,16992.0,13133,8649,150130.82999999996,2,4,4,10
3410,16996.0,6480,1369,53907.52000000002,3,3,4,10
3411,16997.0,3688,144,8424.0,3,1,2,6
3412,16998.0,861,16,1180.0,5,1,1,7
3413,16999.0,1396,529,11150.86,4,2,2,8
3414,17001.0,28831,28561,674237.3300000001,1,5,5,11
3415,17002.0,9340,2401,73192.77000000002,2,3,4,9
3416,17004.0,3128,1849,56422.020000000004,4,3,4,11
3417,17006.0,1445,1936,34398.32,4,3,3,10
3418,17007.0,9211,2704,46276.35999999999,2,3,3,8
3419,17010.0,198,121,2148.96,5,1,1,7
3420,17011.0,450,225,4063.4999999999995,5,2,2,9
3421,17014.0,2362,5184,42006.96000000001,4,4,3,11
3422,17015.0,27700,45796,393462.54,1,5,5,11
3423,17017.0,53272,63504,2190953.52,1,5,5,11
3424,17018.0,2350,256,14721.6,4,2,3,9
3425,17019.0,50080,51984,286842.24,1,5,5,11
3426,17022.0,217,49,497.0,5,1,1,7
3427,17024.0,301,9,287.54999999999995,5,1,1,7
3428,17025.0,2105,81,3219.93,4,1,1,6
3429,17026.0,1292,16,619.3199999999999,5,1,1,7
3430,17027.0,34167,21904,129878.87999999999,1,5,4,10
3431,17029.0,346,4,1432.0,5,1,1,7
3432,17030.0,693,121,1615.5700000000004,5,1,1,7
3433,17031.0,2101,484,8367.7,4,2,2,8
3434,17033.0,5360,784,28843.920000000002,3,2,3,8
3435,17034.0,2736,900,22365.600000000002,4,3,3,10
3436,17035.0,8048,784,12138.84,2,2,2,6
3437,17037.0,6525,5625,95049.0,3,4,4,11
3438,17038.0,660,484,2472.8000000000006,5,2,1,8
3439,17040.0,2055,225,6745.950000000001,4,2,2,8
3440,17041.0,9850,4761,73932.81,2,4,4,10
3441,17042.0,17428,9409,100548.26000000001,2,4,4,10
3442,17043.0,9098,10404,176988.36000000002,2,4,4,10
3443,17044.0,150,36,5690.88,5,1,2,8
3444,17045.0,2835,484,7467.6799999999985,4,2,2,8
3445,17046.0,3454,484,14124.439999999997,4,2,2,8
3446,17047.0,10685,4225,71558.5,2,4,4,10
3447,17048.0,12036,1849,39790.05,2,3,3,8
3448,17049.0,35545,100489,1792644.5100000002,1,5,5,11
3449,17050.0,75796,94864,981177.12,1,5,5,11
3450,17051.0,8148,1764,10117.38,2,3,2,7
3451,17052.0,2324,6889,33124.469999999994,4,4,3,11
3452,17053.0,1690,169,6480.24,4,1,2,7
3453,17054.0,15383,6889,112575.39000000001,2,4,4,10
3454,17058.0,12204,3844,73153.18000000001,2,4,4,10
3455,17059.0,89876,264196,1583320.46,1,5,5,11
3456,17060.0,1330,25,1171.2,4,1,1,6
3457,17061.0,17068,9801,517990.76999999996,2,4,5,11
3458,17062.0,24262,4761,36799.77,1,4,3,8
3459,17063.0,10418,6084,113968.92000000001,2,4,4,10
3460,17064.0,11936,3721,52182.45,2,4,4,10
3461,17068.0,55656,87616,1347433.44,1,5,5,11
3462,17069.0,23200,20449,387487.1,1,5,5,11
3463,17070.0,7068,3844,18862.879999999997,3,4,3,10
3464,17071.0,22518,19600,340064.2,1,5,5,11
3465,17073.0,12600,30276,251619.65999999997,2,5,5,12
3466,17075.0,18129,5929,64227.23999999999,2,4,4,10
3467,17076.0,4855,625,21027.0,3,2,3,8
3468,17078.0,1008,784,10589.600000000002,5,2,2,9
3469,17079.0,156,4,237.6,5,1,1,7
3470,17080.0,423,64,2300.96,5,1,1,7
3471,17081.0,2058,3969,18201.33,4,4,3,11
3472,17082.0,9513,6561,162311.85,2,4,4,10
3473,17083.0,12152,2704,73100.56,2,3,4,9
3474,17084.0,5215,22201,409450.50999999995,3,5,5,13
3475,17085.0,51360,34596,290606.4,1,5,5,11
3476,17086.0,3190,9216,196807.68,4,4,4,12
3477,17088.0,19951,13225,228966.15,1,4,4,9
3478,17090.0,8174,3721,120453.65000000002,2,4,4,10
3479,17091.0,34041,38025,746413.2000000002,1,5,5,11
3480,17092.0,12472,15376,219979.72000000003,2,5,4,11
3481,17094.0,4508,196,4227.999999999999,3,1,2,6
3482,17095.0,11606,5476,97987.84000000001,2,4,4,10
3483,17096.0,5113,2304,49062.24,3,3,3,9
3484,17097.0,29578,44521,201382.62,1,5,4,10
3485,17100.0,1170,4225,63163.1,5,4,4,13
3486,17101.0,4043,1764,68112.66,3,3,4,10
3487,17102.0,261,1,25.5,5,1,1,7
3488,17105.0,19896,8100,59920.19999999999,1,4,4,9
3489,17107.0,59896,173056,4491751.68,1,5,5,11
3490,17109.0,14369,13456,102229.64,2,4,4,10
3491,17110.0,1980,144,1959.6000000000001,4,1,1,6
3492,17111.0,1363,841,6716.6900000000005,4,2,2,8
3493,17114.0,23584,15129,98537.76,1,5,4,10
3494,17115.0,6798,1521,32662.499999999985,3,3,3,9
3495,17117.0,2592,81,1045.8,4,1,1,6
3496,17118.0,3170,100,1570.2,4,1,1,6
3497,17119.0,1841,1225,21241.85,4,3,3,10
3498,17120.0,4194,324,5534.280000000001,3,2,2,7
3499,17122.0,833,49,968.24,5,1,1,7
3500,17123.0,1449,81,3107.7,4,1,1,6
3501,17124.0,5735,961,9121.44,3,3,2,8
3502,17125.0,1750,1225,8067.5,4,3,2,9
3503,17126.0,57793,61504,245383.6,1,5,5,11
3504,17128.0,4676,196,2199.2599999999993,3,1,1,5
3505,17131.0,4870,17956,330064.78,3,5,5,13
3506,17133.0,4073,729,132090.48,3,2,4,9
3507,17134.0,5440,529,9503.6,3,2,2,7
3508,17135.0,7954,2704,59265.96,2,3,4,9
3509,17138.0,6600,576,9132.0,3,2,2,7
3510,17139.0,78839,227529,5080417.29,1,5,5,11
3511,17140.0,4446,324,8174.16,3,2,2,7
3512,17142.0,3585,225,8684.999999999998,4,2,2,8
3513,17144.0,1957,2304,47259.36,4,3,3,10
3514,17146.0,10409,1225,26242.3,2,3,3,8
3515,17147.0,13238,6561,138881.78999999998,2,4,4,10
3516,17148.0,459,81,1123.92,5,1,1,7
3517,17152.0,3268,196,23653.0,4,1,3,8
3518,17153.0,336,196,2992.92,5,1,1,7
3519,17154.0,1725,529,7574.82,4,2,2,8
3520,17155.0,1780,400,5033.999999999999,4,2,2,8
3521,17157.0,1443,169,4147.0,4,1,2,7
3522,17158.0,13144,4489,84886.99,2,4,4,10
3523,17159.0,7971,10201,155426.88,2,4,4,10
3524,17160.0,34428,52441,805628.87,1,5,5,11
3525,17162.0,21485,10816,178407.84,1,4,4,9
3526,17163.0,276,25,1465.5,5,1,1,7
3527,17164.0,21695,20736,355298.39999999997,1,5,5,11
3528,17165.0,2840,100,1586.8000000000002,4,1,1,6
3529,17166.0,2106,144,2476.08,4,1,1,6
3530,17169.0,5346,2916,45132.12000000001,3,3,3,9
3531,17171.0,4624,256,3598.56,3,2,1,6
3532,17172.0,1170,225,4766.4,5,2,2,9
3533,17173.0,4691,7396,323927.6,3,4,5,12
3534,17174.0,868,16,239.6,5,1,1,7
3535,17175.0,12896,3969,90952.47,2,4,4,10
3536,17176.0,3015,225,4591.95,4,2,2,8
3537,17179.0,20006,6400,56943.2,1,4,4,9
3538,17180.0,28365,15625,97996.25000000003,1,5,4,10
3539,17181.0,1943,529,5518.16,4,2,2,8
3540,17183.0,3275,5329,244353.63,4,4,5,13
3541,17186.0,106,4,288.0,5,1,1,7
3542,17187.0,2260,100,2039.5,4,1,1,6
3543,17188.0,15720,7056,207835.32,2,4,4,10
3544,17189.0,15721,3600,23025.000000000004,2,4,3,9
3545,17190.0,1251,361,8450.06,5,2,2,9
3546,17191.0,48656,55696,494108.48,1,5,5,11
3547,17193.0,2697,1024,54377.600000000006,4,3,4,11
3548,17194.0,10353,841,7615.9800000000005,2,2,2,6
3549,17197.0,841,841,29377.29,5,2,3,10
3550,17198.0,28860,9216,66453.12,1,4,4,9
3551,17201.0,2014,1444,11011.640000000001,4,3,2,9
3552,17203.0,6088,21904,526891.84,3,5,5,13
3553,17204.0,13517,3249,89179.92,2,3,4,9
3554,17205.0,689,169,4993.04,5,1,2,8
3555,17206.0,371,49,1429.68,5,1,1,7
3556,17211.0,45037,44521,488933.42000000004,1,5,5,11
3557,17212.0,1012,16,907.4,5,1,1,7
3558,17213.0,26289,24649,436653.1100000001,1,5,5,11
3559,17214.0,22285,10201,106971.12,1,4,4,9
3560,17217.0,2106,81,1021.5,4,1,1,6
3561,17218.0,50968,73441,528983.87,1,5,5,11
3562,17219.0,775,625,2855.75,5,2,1,8
3563,17220.0,76603,218089,1488585.85,1,5,5,11
3564,17221.0,1304,3844,20737.760000000002,5,4,3,12
3565,17222.0,1755,729,8873.55,4,2,2,8
3566,17223.0,16620,2304,20010.72,2,3,3,8
3567,17226.0,6468,441,8263.29,3,2,2,7
3568,17227.0,7554,2209,44148.04,3,3,3,9
3569,17228.0,31240,43264,396466.72,1,5,5,11
3570,17229.0,5984,2209,14981.720000000003,3,3,3,9
3571,17230.0,22752,4761,251050.28999999998,1,4,5,10
3572,17231.0,90258,281961,1659226.3199999998,1,5,5,11
3573,17232.0,274,1225,14621.949999999999,5,3,3,11
3574,17233.0,875,625,4772.0,5,2,2,9
3575,17234.0,2548,196,2098.46,4,1,1,6
3576,17235.0,4195,841,15951.740000000005,3,2,3,8
3577,17236.0,19979,11025,96193.65,1,4,4,9
3578,17237.0,341,361,5979.11,5,2,2,9
3579,17238.0,89647,308025,2064100.5,1,5,5,11
3580,17239.0,4680,225,5737.500000000001,3,2,2,7
3581,17242.0,6408,1600,45401.6,3,3,3,9
3582,17243.0,60877,149769,3304999.3499999996,1,5,5,11
3583,17244.0,1643,961,29601.899999999998,4,3,3,10
3584,17245.0,1836,81,1543.05,4,1,1,6
3585,17247.0,810,2916,15124.860000000002,5,3,3,11
3586,17248.0,8280,4761,21986.850000000002,2,4,3,9
3587,17250.0,6102,3136,21390.32,3,3,3,9
3588,17251.0,13394,1369,9983.710000000001,2,3,2,7
3589,17252.0,15926,7396,30006.260000000002,2,4,3,9
3590,17253.0,324,324,3208.68,5,2,1,8
3591,17254.0,1038,12321,30102.09,5,4,3,12
3592,17255.0,12543,5476,21569.52,2,4,3,9
3593,17256.0,4172,256,3840.0,3,2,2,7
3594,17259.0,35208,13456,67422.68,1,4,4,9
3595,17262.0,2720,144,15040.32,4,1,3,8
3596,17263.0,4784,529,1459.1200000000001,3,2,1,6
3597,17265.0,19944,14884,67101.22000000002,1,5,4,10
3598,17266.0,2659,5329,21650.34,4,4,3,11
3599,17267.0,4699,1369,11736.4,3,3,2,8
3600,17268.0,1002,36,4581.84,5,1,2,8
3601,17272.0,19910,12996,244943.82000000012,1,4,5,10
3602,17274.0,875,625,2695.5,5,2,1,8
3603,17277.0,20603,4761,73509.15,1,4,4,9
3604,17278.0,3615,225,3690.6,4,2,1,7
3605,17279.0,513,81,1690.47,5,1,1,7
3606,17282.0,25136,7921,150005.94,1,4,4,9
3607,17284.0,68710,84681,479416.68,1,5,5,11
3608,17286.0,924,1936,6660.280000000001,5,3,2,10
3609,17287.0,20243,14884,127985.32000000002,1,5,4,10
3610,17288.0,8915,19600,198468.2,2,5,4,11
3611,17289.0,8096,10816,96826.08,2,4,4,10
3612,17290.0,951,9216,49248.96,5,4,3,12
3613,17291.0,308,1,550.8000000000001,5,1,1,7
3614,17293.0,15492,17424,244735.91999999998,2,5,5,12
3615,17295.0,2948,4624,37196.0,4,4,3,11
3616,17297.0,833,2401,6280.820000000001,5,3,2,10
3617,17298.0,3122,900,14952.6,4,3,3,10
3618,17299.0,6172,3025,36113.55,3,3,3,9
3619,17301.0,1239,3481,9631.16,5,4,2,11
3620,17302.0,11303,6241,89714.77,2,4,4,10
3621,17303.0,19133,2809,13252.119999999999,1,3,2,6
3622,17306.0,10803,4356,569666.4600000001,2,4,5,11
3623,17309.0,1140,144,993.0,5,1,1,7
3624,17311.0,10002,3025,76166.75,2,3,4,9
3625,17312.0,2193,196,9020.199999999999,4,1,2,7
3626,17313.0,744,576,55892.16,5,2,4,11
3627,17314.0,18407,17161,331157.52,2,5,5,12
3628,17315.0,83110,221841,2958459.3299999996,1,5,5,11
3629,17317.0,721,81,23403.06,5,1,3,9
3630,17320.0,16732,5329,87645.26,2,4,4,10
3631,17321.0,6574,9801,65058.84,3,4,4,11
3632,17323.0,27536,38025,176771.4,1,5,4,10
3633,17324.0,6501,2401,48337.520000000004,3,3,3,9
3634,17325.0,1680,36,580.8,4,1,1,6
3635,17329.0,5278,1089,17262.63,3,3,3,9
3636,17330.0,357,36,2183.3999999999996,5,1,1,7
3637,17331.0,123,1,175.2,5,1,1,7
3638,17333.0,2380,784,13839.0,4,2,2,8
3639,17334.0,3382,121,3377.2200000000003,4,1,1,6
3640,17337.0,139895,271441,1032132.26,1,5,5,11
3641,17338.0,132772,519841,4681842.34,1,5,5,11
3642,17339.0,1930,81,2190.2400000000002,4,1,1,6
3643,17340.0,76885,165649,5027789.03,1,5,5,11
3644,17341.0,53052,24649,107119.53,1,5,4,10
3645,17343.0,6035,289,3291.8799999999997,3,2,1,6
3646,17344.0,1426,961,4886.219999999999,4,3,2,9
3647,17345.0,6060,6889,43134.270000000004,3,4,3,10
3648,17346.0,63780,233289,1266851.04,1,5,5,11
3649,17347.0,86,1,228.96,5,1,1,7
3650,17348.0,17490,45369,246355.8,2,5,5,12
3651,17349.0,1432,64,786.0,4,1,1,6
3652,17350.0,2918,4900,89692.40000000002,4,4,4,12
3653,17351.0,3811,729,15853.05,3,2,3,8
3654,17353.0,1132,64,13920.0,5,1,2,8
3655,17354.0,800,256,22288.96,5,2,3,10
3656,17356.0,5909,361,3386.1799999999994,3,2,1,6
3657,17357.0,1056,1936,16913.16,5,3,3,11
3658,17358.0,19706,3364,20926.98,1,4,3,8
3659,17359.0,165,225,1917.9,5,2,1,8
3660,17360.0,11644,15625,71030.00000000001,2,5,4,11
3661,17361.0,3855,841,14157.800000000003,3,2,2,7
3662,17362.0,9205,1225,10928.050000000001,2,3,2,7
3663,17364.0,59651,164836,1811848.08,1,5,5,11
3664,17365.0,75615,216225,2216822.4000000004,1,5,5,11
3665,17367.0,7854,1089,5529.15,3,3,2,8
3666,17368.0,17963,11449,201039.09,2,4,4,10
3667,17370.0,3428,1089,14723.94,4,3,3,10
3668,17371.0,3870,7396,35982.4,3,4,3,10
3669,17372.0,57122,63001,335632.18,1,5,5,11
3670,17373.0,8279,3249,36874.44,2,3,3,8
3671,17374.0,6860,784,13881.559999999998,3,2,2,7
3672,17375.0,19619,4761,27606.9,1,4,3,8
3673,17376.0,4813,576,4876.799999999999,3,2,2,7
3674,17377.0,52598,163216,1639561.28,1,5,5,11
3675,17379.0,858,6084,30398.160000000003,5,4,3,12
3676,17381.0,24283,11881,2210041.49,1,4,5,10
3677,17382.0,130,4,130.8,5,1,1,7
3678,17383.0,196,2401,9476.109999999999,5,3,2,10
3679,17384.0,885,225,5046.0,5,2,2,9
3680,17385.0,630,2025,11524.95,5,3,2,10
3681,17386.0,1632,784,75219.76000000001,4,2,4,10
3682,17387.0,1696,5776,56757.56,4,4,4,12
3683,17388.0,2093,225,18893.4,4,2,3,9
3684,17389.0,28042,45369,6780573.84,1,5,5,11
3685,17391.0,491,9,1526.4,5,1,1,7
3686,17392.0,19372,3136,23367.12,1,3,3,7
3687,17394.0,876,16,815.4799999999998,5,1,1,7
3688,17396.0,3852,729,197931.6,3,2,4,9
3689,17397.0,1958,7921,60645.49,4,4,4,12
3690,17398.0,8163,1444,24828.44,2,3,3,8
3691,17400.0,42869,42436,432155.04000000004,1,5,5,11
3692,17402.0,13605,3481,155397.14999999997,2,4,4,10
3693,17403.0,1152,1024,8445.44,5,3,2,10
3694,17404.0,36885,39204,6317550.36,1,5,5,11
3695,17405.0,8108,6724,84575.62000000001,2,4,4,10
3696,17406.0,37590,12321,242470.62,1,4,5,10
3697,17408.0,326,4,65.3,5,1,1,7
3698,17409.0,2712,169,10034.05,4,1,2,7
3699,17410.0,5703,4096,77742.08,3,4,4,11
3700,17411.0,5484,1681,31936.539999999997,3,3,3,9
3701,17412.0,12057,4356,83031.96,2,4,4,10
3702,17414.0,963,36,4668.0,5,1,2,8
3703,17415.0,1106,196,7109.759999999998,5,1,2,8
3704,17416.0,45242,72361,1854329.98,1,5,5,11
3705,17418.0,4632,900,13903.8,3,3,2,8
3706,17419.0,37205,42436,870673.4199999999,1,5,5,11
3707,17420.0,5455,900,17964.9,3,3,3,9
3708,17422.0,18974,13689,231586.28999999998,1,4,4,9
3709,17423.0,3077,676,18158.66,4,2,3,9
3710,17425.0,2539,1849,32644.310000000005,4,3,3,10
3711,17426.0,42184,73441,1365097.46,1,5,5,11
3712,17427.0,142,4,201.6,5,1,1,7
3713,17428.0,65419,107584,5660246.8,1,5,5,11
3714,17429.0,7149,1521,20471.880000000005,3,3,3,9
3715,17430.0,2113,196,3720.640000000001,4,1,1,6
3716,17431.0,13459,1849,17341.9,2,3,3,8
3717,17432.0,1149,2304,17556.48,5,3,3,11
3718,17433.0,4752,2916,16370.640000000001,3,3,3,9
3719,17434.0,4523,17956,318091.88,3,5,5,13
3720,17436.0,909,81,1946.7,5,1,1,7
3721,17438.0,4301,289,6603.6500000000015,3,2,2,7
3722,17440.0,1053,25,932.0999999999999,5,1,1,7
3723,17442.0,21658,18225,303555.6,1,5,5,11
3724,17443.0,219,1,534.24,5,1,1,7
3725,17444.0,21578,18225,396905.4,1,5,5,11
3726,17446.0,2254,81,1088.1000000000001,4,1,1,6
3727,17447.0,2308,1296,19495.079999999998,4,3,3,10
3728,17449.0,53932,76176,695301.96,1,5,5,11
3729,17450.0,51416,112896,65315305.440000005,1,5,5,11
3730,17451.0,5369,10000,172140.0,3,4,4,11
3731,17453.0,746,361,9247.68,5,2,2,9
3732,17454.0,17056,3721,31569.329999999998,2,4,3,9
3733,17455.0,1624,64,1053.6,4,1,1,6
3734,17456.0,6205,289,4247.62,3,2,2,7
3735,17457.0,4304,361,33016.3,3,2,3,8
3736,17458.0,810,2916,17090.999999999996,5,3,3,11
3737,17459.0,6065,12321,72960.29999999999,3,4,4,11
3738,17460.0,6805,841,18050.469999999998,3,2,3,8
3739,17461.0,2661,11236,77996.92,4,4,4,12
3740,17462.0,4756,729,18243.629999999997,3,2,3,8
3741,17463.0,38121,43264,390178.88,1,5,5,11
3742,17464.0,1422,81,2609.6400000000003,4,1,1,6
3743,17466.0,1974,1681,31294.48,4,3,3,10
3744,17468.0,66,25,685.0,5,1,1,7
3745,17469.0,9763,7744,164645.36000000004,2,4,4,10
3746,17470.0,14296,6084,87755.46,2,4,4,10
3747,17472.0,44985,30276,121371.96,1,5,4,10
3748,17475.0,1106,196,2721.1799999999994,5,1,1,7
3749,17480.0,2233,841,14842.78,4,2,3,9
3750,17481.0,3027,6724,102958.37999999999,4,4,4,12
3751,17483.0,2605,441,8694.84,4,2,2,8
3752,17486.0,6264,576,9524.880000000001,3,2,2,7
3753,17489.0,4146,841,10922.559999999998,3,2,2,7
3754,17490.0,5678,5776,159016.32,3,4,4,11
3755,17491.0,15309,11881,387916.83,2,4,5,11
3756,17492.0,2976,144,4494.84,4,1,2,7
3757,17495.0,809,729,13434.12,5,2,2,9
3758,17496.0,3580,100,2710.5,4,1,1,6
3759,17498.0,1275,289,4627.740000000001,5,2,2,9
3760,17499.0,11560,1600,24915.2,2,3,3,8
3761,17500.0,127,25,5690.0,5,1,2,8
3762,17501.0,3960,324,5194.8,3,2,2,7
3763,17502.0,516,784,19294.799999999996,5,2,3,10
3764,17503.0,904,1444,21240.479999999996,5,3,3,11
3765,17504.0,32954,16129,380622.81,1,5,5,11
3766,17505.0,9516,2704,59583.67999999999,2,3,4,9
3767,17506.0,1050,196,4230.800000000001,5,1,2,8
3768,17507.0,25128,7744,53291.04,1,4,4,9
3769,17508.0,6160,484,8520.82,3,2,2,7
3770,17509.0,22461,132496,2214444.96,1,5,5,11
3771,17510.0,480,400,6169.6,5,2,2,9
3772,17511.0,161364,927369,87693071.94,1,5,5,11
3773,17512.0,18317,11025,307123.94999999995,2,4,5,11
3774,17513.0,432,36,3079.2000000000003,5,1,1,7
3775,17514.0,5120,1600,8346.0,3,3,2,8
3776,17515.0,21256,7569,55594.74,1,4,4,9
3777,17516.0,26581,18225,103258.79999999999,1,5,4,10
3778,17517.0,3388,121,1693.34,4,1,1,6
3779,17519.0,16524,6724,151209.63999999998,2,4,4,10
3780,17520.0,1590,900,16404.3,4,3,3,10
3781,17521.0,3493,2025,32544.45,4,3,3,10
3782,17522.0,12326,5329,78161.83,2,4,4,10
3783,17523.0,555,1089,21540.420000000002,5,3,3,11
3784,17524.0,2166,36,870.0,4,1,1,6
3785,17525.0,3231,81,3804.2999999999997,4,1,2,7
3786,17526.0,3381,361,22722.100000000002,4,2,3,9
3787,17527.0,5032,2209,44150.39,3,3,3,9
3788,17528.0,13342,64009,918010.5,2,5,5,12
3789,17530.0,77051,152100,923176.7999999999,1,5,5,11
3790,17531.0,2660,196,4153.8,4,1,2,7
3791,17534.0,477,81,2010.2400000000002,5,1,1,7
3792,17535.0,3640,169,2137.2,4,1,1,6
3793,17536.0,531,9,229.5,5,1,1,7
3794,17537.0,18586,5476,65687.58,2,4,4,10
3795,17538.0,225,81,885.78,5,1,1,7
3796,17540.0,2936,625,14472.5,4,2,3,9
3797,17542.0,6725,625,4268.75,3,2,2,7
3798,17545.0,6063,19881,90567.12,3,5,4,12
3799,17548.0,1165,25,516.5,5,1,1,7
3800,17549.0,194,36,893.1600000000001,5,1,1,7
3801,17550.0,9562,1764,11220.720000000003,2,3,2,7
3802,17551.0,14001,1521,11323.259999999998,2,3,2,7
3803,17552.0,7381,2401,45590.09,3,3,3,9
3804,17553.0,258,4,2975.2,5,1,1,7
3805,17554.0,9726,7744,171815.6,2,4,4,10
3806,17555.0,17430,11025,50432.55,2,4,3,9
3807,17556.0,1230,36,947.4000000000001,5,1,1,7
3808,17557.0,1996,1156,18409.639999999996,4,3,3,10
3809,17560.0,5406,729,23083.650000000005,3,2,3,8
3810,17561.0,855,2025,7430.399999999999,5,3,2,10
3811,17562.0,7183,3969,70709.94,3,4,4,11
3812,17564.0,2312,2401,22246.489999999998,4,3,3,10
3813,17566.0,2173,20164,123507.34,4,5,4,13
3814,17567.0,34211,27225,714694.2,1,5,5,11
3815,17569.0,9628,841,9980.06,2,2,2,6
3816,17571.0,27518,73441,386356.57,1,5,5,11
3817,17572.0,2784,144,2721.0,4,1,1,6
3818,17573.0,1485,625,9515.0,4,2,2,8
3819,17574.0,1936,64,1485.2,4,1,1,6
3820,17576.0,63789,161604,1433061.66,1,5,5,11
3821,17578.0,1090,25,717.3,5,1,1,7
3822,17579.0,2923,2500,22444.999999999996,4,3,3,10
3823,17580.0,14118,2025,9707.4,2,3,2,7
3824,17581.0,68484,192721,4840080.36,1,5,5,11
3825,17582.0,6844,841,5082.83,3,2,2,7
3826,17584.0,2165,1225,43480.50000000001,4,3,3,10
3827,17585.0,39334,43264,232269.44,1,5,4,10
3828,17588.0,3764,529,28524.600000000002,3,2,3,8
3829,17589.0,39950,64009,608255.01,1,5,5,11
3830,17590.0,4403,38416,287731.92,3,5,5,13
3831,17591.0,46551,24649,345976.19,1,5,5,11
3832,17593.0,28747,44944,831858.3200000001,1,5,5,11
3833,17594.0,6616,2500,49659.0,3,3,3,9
3834,17595.0,1809,6724,31708.580000000005,4,4,3,11
3835,17596.0,45170,70225,743772.85,1,5,5,11
3836,17597.0,11715,3025,112440.34999999999,2,3,4,9
3837,17600.0,221,169,2101.71,5,1,1,7
3838,17601.0,2151,81,1044.0900000000001,4,1,1,6
3839,17602.0,51240,303601,2784985.42,1,5,5,11
3840,17603.0,858,121,4341.92,5,1,2,8
3841,17604.0,16236,3969,19489.68,2,4,3,9
3842,17608.0,1848,3136,10751.44,4,3,2,9
3843,17609.0,42906,54289,257646.74,1,5,5,11
3844,17611.0,128838,321489,2245955.04,1,5,5,11
3845,17612.0,19909,18225,276540.75,1,5,5,11
3846,17613.0,59499,93636,1390632.3,1,5,5,11
3847,17614.0,5586,9604,37859.36,3,4,3,10
3848,17615.0,2718,196,4614.4000000000015,4,1,2,7
3849,17616.0,794,9,1713.6000000000001,5,1,1,7
3850,17618.0,18488,4489,62328.759999999995,2,4,4,10
3851,17619.0,23088,5476,15863.380000000001,1,4,3,8
3852,17620.0,236,16,325.76,5,1,1,7
3853,17621.0,5079,676,35877.4,3,2,3,8
3854,17623.0,1056,1089,17392.65,5,3,3,11
3855,17624.0,5800,2500,42174.0,3,3,3,9
3856,17625.0,41971,93636,618242.4,1,5,5,11
3857,17628.0,405,25,378.75000000000006,5,1,1,7
3858,17629.0,19231,15129,223136.75999999998,1,5,4,10
3859,17630.0,5591,676,13093.6,3,2,2,7
3860,17631.0,5978,1521,20604.870000000006,3,3,3,9
3861,17633.0,5686,4900,92738.79999999999,3,4,4,11
3862,17634.0,58158,87616,698142.64,1,5,5,11
3863,17636.0,380,400,5711.199999999999,5,2,2,9
3864,17637.0,3101,1225,19147.100000000002,4,3,3,10
3865,17639.0,1932,49,759.5,4,1,1,6
3866,17640.0,430,25,3108.3,5,1,1,7
3867,17642.0,6242,1600,28491.6,3,3,3,9
3868,17643.0,2984,64,812.4,4,1,1,6
3869,17644.0,20015,24649,454615.48,1,5,5,11
3870,17646.0,13599,2601,51427.89,2,3,4,9
3871,17647.0,455,49,931.4200000000001,5,1,1,7
3872,17648.0,16092,8281,163572.5,2,4,4,10
3873,17649.0,7176,2704,45161.48,3,3,3,9
3874,17650.0,168,64,1328.6399999999999,5,1,1,7
3875,17651.0,20622,53824,915240.0,1,5,5,11
3876,17652.0,35906,67081,1260739.48,1,5,5,11
3877,17653.0,2301,1936,53132.64,4,3,4,11
3878,17654.0,6094,484,2586.1,3,2,1,6
3879,17655.0,15940,8281,240143.54000000004,2,4,5,11
3880,17656.0,7959,6724,137324.58000000005,2,4,4,10
3881,17658.0,2149,361,11312.98,4,2,2,8
3882,17659.0,19772,24964,473914.68,1,5,5,11
3883,17660.0,5358,1444,6792.500000000001,3,3,2,8
3884,17663.0,13117,7396,155050.26000000004,2,4,4,10
3885,17664.0,5236,1849,25999.52,3,3,3,9
3886,17666.0,798,324,13106.879999999997,5,2,2,9
3887,17667.0,25638,13689,240494.67,1,4,5,10
3888,17668.0,311,225,5216.25,5,2,2,9
3889,17669.0,10825,4624,231656.96,2,4,4,10
3890,17670.0,2497,121,2262.7,4,1,1,6
3891,17671.0,11173,2809,83353.63000000002,2,3,4,9
3892,17672.0,16119,12100,349598.7,2,4,5,11
3893,17673.0,41861,47524,347703.45999999996,1,5,5,11
3894,17674.0,5232,729,14878.080000000002,3,2,3,8
3895,17675.0,102550,497025,14363867.399999999,1,5,5,11
3896,17676.0,9859,5929,105580.86,2,4,4,10
3897,17677.0,48854,91809,4952650.14,1,5,5,11
3898,17678.0,4208,256,4769.76,3,2,2,7
3899,17679.0,2418,900,59763.299999999996,4,3,4,11
3900,17680.0,253,121,2028.4,5,1,1,7
3901,17682.0,19428,13924,291970.93999999994,1,4,5,10
3902,17684.0,645,225,3591.15,5,2,1,8
3903,17685.0,22692,16129,400790.4099999999,1,5,5,11
3904,17686.0,47614,81796,1641485.5600000003,1,5,5,11
3905,17690.0,47975,63504,1191153.6,1,5,5,11
3906,17691.0,6892,361,5517.599999999999,3,2,2,7
3907,17692.0,13581,2116,34083.23999999999,2,3,3,8
3908,17693.0,2192,256,3207.52,4,2,1,7
3909,17694.0,2115,225,4246.8,4,2,2,8
3910,17695.0,5305,1225,26786.900000000005,3,3,3,9
3911,17696.0,18200,13225,262856.6500000001,2,4,5,11
3912,17697.0,4484,361,6440.050000000001,3,2,2,7
3913,17698.0,2080,64,1239.6,4,1,1,6
3914,17700.0,19668,20164,359918.88,1,5,5,11
3915,17701.0,6048,576,10030.800000000003,3,2,2,7
3916,17702.0,10000,5476,135003.38,2,4,4,10
3917,17703.0,5082,3025,43930.7,3,3,3,9
3918,17704.0,6344,961,27440.89,3,3,3,9
3919,17705.0,12869,10609,187822.56,2,4,4,10
3920,17706.0,58959,145924,4012715.1799999997,1,5,5,11
3921,17707.0,1378,25,761.9999999999999,4,1,1,6
3922,17708.0,9783,1156,8953.22,2,3,2,7
3923,17709.0,1183,49,962.1499999999999,5,1,1,7
3924,17711.0,3857,529,8857.300000000001,3,2,2,7
3925,17712.0,1276,841,15164.39,5,2,3,10
3926,17714.0,3200,100,1530.0,4,1,1,6
3927,17715.0,200,1,326.4,5,1,1,7
3928,17716.0,39695,60025,1385717.55,1,5,5,11
3929,17718.0,1392,36,836.0999999999999,4,1,1,6
3930,17719.0,43283,75076,1478514.96,1,5,5,11
3931,17720.0,6565,2500,59797.0,3,3,4,10
3932,17722.0,31797,13225,278764.6,1,4,5,10
3933,17723.0,1873,100,32764.0,4,1,3,8
3934,17724.0,3667,1600,41320.0,3,3,3,9
3935,17725.0,27397,36864,660303.36,1,5,5,11
3936,17727.0,990,4356,69976.5,5,4,4,13
3937,17728.0,9161,27225,474541.65,2,5,5,12
3938,17730.0,32292,47524,1155068.64,1,5,5,11
3939,17731.0,9454,4489,83087.37,2,4,4,10
3940,17732.0,6696,324,5471.460000000001,3,2,2,7
3941,17733.0,4006,1225,24226.649999999998,3,3,3,9
3942,17734.0,5891,1849,30127.09,3,3,3,9
3943,17735.0,121862,476100,9045913.8,1,5,5,11
3944,17736.0,2650,625,9436.0,4,2,2,8
3945,17737.0,384,100,1682.4,5,1,1,7
3946,17738.0,17270,9409,182267.85,2,4,4,10
3947,17739.0,6754,2209,131193.45,3,3,4,10
3948,17742.0,4542,225,5326.650000000001,3,2,2,7
3949,17744.0,20676,18496,315846.4,1,5,5,11
3950,17746.0,1440,36,661.5,4,1,1,6
3951,17747.0,112,1,71.4,5,1,1,7
3952,17749.0,7946,1225,23608.2,2,3,3,8
3953,17750.0,21010,33856,314722.8,1,5,5,11
3954,17752.0,359,1,80.64,5,1,1,7
3955,17754.0,10135,7921,148153.85,2,4,4,10
3956,17757.0,115881,547600,4139108.6,1,5,5,11
3957,17758.0,50693,163216,1376912.8,1,5,5,11
3958,17759.0,4266,8100,73796.40000000001,3,4,4,11
3959,17760.0,3693,625,7189.750000000001,3,2,2,7
3960,17761.0,608,361,13542.82,5,2,2,9
3961,17763.0,263,1,15.0,5,1,1,7
3962,17764.0,6287,5041,54851.05,3,4,4,11
3963,17765.0,11958,3136,20587.28,2,3,3,8
3964,17767.0,315,441,5695.200000000001,5,2,2,9
3965,17768.0,5585,9604,204026.2,3,4,4,11
3966,17769.0,46192,92416,1203058.72,1,5,5,11
3967,17770.0,9869,1444,43444.25999999999,2,3,3,8
3968,17771.0,8898,2916,13273.740000000002,2,3,2,7
3969,17772.0,500,2500,8672.5,5,3,2,10
3970,17774.0,29035,23409,185700.69,1,5,4,10
3971,17775.0,762,9,169.2,5,1,1,7
3972,17777.0,10445,36100,123036.4,2,5,4,11
3973,17779.0,7895,6561,52675.920000000006,3,4,4,11
3974,17781.0,2096,144,2256.2400000000002,4,1,1,6
3975,17783.0,10074,4489,18992.489999999994,2,4,3,9
3976,17785.0,689,169,1715.22,5,1,1,7
3977,17786.0,11580,4624,18145.800000000007,2,4,3,9
3978,17787.0,39507,16384,232645.12,1,5,5,11
3979,17788.0,533,25,5589.5,5,1,2,8
3980,17789.0,3934,196,3162.6,3,1,1,5
3981,17790.0,29719,35721,371252.7,1,5,5,11
3982,17791.0,290,100,1061.0,5,1,1,7
3983,17793.0,1300,2704,15617.679999999998,5,3,3,11
3984,17795.0,9415,2025,15427.349999999995,2,3,3,8
3985,17796.0,26039,6561,55890.0,1,4,4,9
3986,17797.0,9482,12321,86627.73000000003,2,4,4,10
3987,17799.0,79129,163216,1227824.68,1,5,5,11
3988,17800.0,15699,10609,122282.63,2,4,4,10
3989,17802.0,21134,19600,179905.6,1,5,4,10
3990,17805.0,730,100,5123.099999999999,5,1,2,8
3991,17806.0,473,1849,23479.719999999998,5,3,3,11
3992,17809.0,9966,3721,330126.51,2,4,5,11
3993,17811.0,130790,685584,6426786.96,1,5,5,11
3994,17812.0,12381,17689,93074.73,2,5,4,11
3995,17813.0,20000,121104,590928.3600000001,1,5,5,11
3996,17816.0,4251,289,621.52,3,2,1,6
3997,17817.0,3681,1089,12793.44,3,3,2,8
3998,17819.0,12931,2304,177833.76,2,3,4,9
3999,17824.0,663,169,3879.2,5,1,2,8
4000,17827.0,51115,46225,427275.95,1,5,5,11
4001,17828.0,9620,4489,121946.03,2,4,4,10
4002,17829.0,8940,900,26677.2,2,3,3,8
4003,17830.0,4480,529,9170.099999999999,3,2,2,7
4004,17831.0,66,4,70.80000000000001,5,1,1,7
4005,17832.0,2989,3721,9477.570000000002,4,4,2,10
4006,17835.0,664,3481,20192.159999999996,5,4,3,12
4007,17836.0,1128,576,2645.04,5,2,1,8
4008,17837.0,12732,26244,249679.26,2,5,5,12
4009,17838.0,27889,13689,318333.60000000003,1,4,5,10
4010,17839.0,2184,2704,16543.800000000003,4,3,3,10
4011,17841.0,1000748,58920976,311030291.84,1,5,5,11
4012,17843.0,11211,1369,7602.759999999999,2,3,2,7
4013,17844.0,530,25,257.8,5,1,1,7
4014,17846.0,85,1,2033.1,5,1,1,7
4015,17848.0,11542,2601,45961.200000000004,2,3,3,8
4016,17849.0,7512,676,15750.800000000001,3,2,3,8
4017,17850.0,110568,88209,1601189.3700000003,1,5,5,11
4018,17852.0,264,576,2744.16,5,2,1,8
4019,17854.0,3279,225,4668.9,4,2,2,8
4020,17855.0,6324,289,3552.49,3,2,1,6
4021,17856.0,2405,225,21270.450000000004,4,2,3,9
4022,17857.0,7107,2916,1451468.1600000001,3,3,5,11
4023,17858.0,26483,38809,1012710.02,1,5,5,11
4024,17859.0,6992,529,3264.1600000000003,3,2,1,6
4025,17860.0,19136,2704,11775.4,1,3,2,6
4026,17861.0,26466,47961,459435.72000000003,1,5,5,11
4027,17862.0,3553,121,3639.8999999999996,4,1,1,6
4028,17863.0,27820,21904,467680.0,1,5,5,11
4029,17864.0,12929,8100,49936.5,2,4,3,9
4030,17865.0,65103,136900,3894738.4,1,5,5,11
4031,17866.0,1278,81,2966.85,5,1,1,7
4032,17867.0,3329,4624,78735.15999999999,4,4,4,12
4033,17869.0,10062,1600,17127.2,2,3,3,8
4034,17870.0,15429,72900,503790.30000000005,2,5,5,12
4035,17871.0,2040,100,1559.0000000000005,4,1,1,6
4036,17873.0,10267,1849,79505.28000000003,2,3,4,9
4037,17874.0,10230,2116,31439.160000000007,2,3,3,8
4038,17877.0,2040,144,2851.32,4,1,1,6
4039,17878.0,1118,676,9865.699999999999,5,2,2,9
4040,17879.0,1038,36,1071.12,5,1,1,7
4041,17880.0,9464,676,11931.92,2,2,2,6
4042,17881.0,2432,64,1066.8000000000002,4,1,1,6
4043,17883.0,7341,20164,94336.28,3,5,4,12
4044,17884.0,32042,12769,78542.91,1,4,4,9
4045,17885.0,636,2809,8286.02,5,3,2,10
4046,17886.0,11802,10404,88666.56,2,4,4,10
4047,17887.0,1290,100,1113.5,5,1,1,7
4048,17888.0,10388,4225,46540.0,2,4,3,9
4049,17889.0,5450,400,4027.4,3,2,2,7
4050,17890.0,31720,8281,53406.99000000001,1,4,4,9
4051,17891.0,5508,1156,6931.240000000001,3,3,2,8
4052,17892.0,4143,784,6834.8,3,2,2,7
4053,17893.0,3375,225,1608.1500000000003,4,2,1,7
4054,17894.0,51961,36864,214840.32,1,5,4,10
4055,17895.0,660,225,1431.75,5,2,1,8
4056,17896.0,46,4,512.64,5,1,1,7
4057,17897.0,32040,11664,58515.48000000002,1,4,4,9
4058,17898.0,4820,784,4257.68,3,2,2,7
4059,17899.0,4929,961,4791.05,3,3,2,8
4060,17900.0,1140,36,673.2,5,1,1,7
4061,17901.0,551,361,2097.22,5,2,1,8
4062,17904.0,714,1156,6156.38,5,3,2,10
4063,17905.0,10817,1089,26366.670000000002,2,3,3,8
4064,17906.0,2964,144,874.8000000000001,4,1,1,6
4065,17908.0,20142,2916,12529.619999999999,1,3,2,6
4066,17911.0,351,1521,14282.970000000001,5,3,2,10
4067,17912.0,13274,1369,11472.22,2,3,2,7
4068,17913.0,12571,3364,23701.699999999997,2,4,3,9
4069,17914.0,225,5625,24702.0,5,4,3,12
4070,17917.0,20612,8464,30822.760000000002,1,4,3,8
4071,17919.0,2024,529,29992.920000000006,4,2,3,9
4072,17920.0,75919,442225,2739467.5,1,5,5,11
4073,17921.0,22996,20164,116472.65999999999,1,5,4,10
4074,17923.0,282,1,207.50000000000003,5,1,1,7
4075,17924.0,2531,961,91837.50000000003,4,3,4,11
4076,17925.0,372,1,244.08,5,1,1,7
4077,17926.0,3563,441,8343.09,4,2,2,8
4078,17928.0,4452,529,4888.42,3,2,2,7
4079,17929.0,993,25,4215.0,5,1,2,8
4080,17930.0,4586,1521,67878.71999999999,3,3,4,10
4081,17931.0,14760,4225,26543.4,2,4,3,9
4082,17932.0,13422,8100,119841.29999999999,2,4,4,10
4083,17934.0,1204,441,14789.25,5,2,3,10
4084,17935.0,4083,841,4227.910000000001,3,2,2,7
4085,17936.0,360,5184,27369.36,5,4,3,12
4086,17937.0,10130,1849,184952.46000000002,2,3,4,9
4087,17939.0,1908,144,1189.68,4,1,1,6
4088,17940.0,3890,324,72360.72,3,2,4,9
4089,17941.0,260,4,609.12,5,1,1,7
4090,17942.0,14,4,155.00000000000003,5,1,1,7
4091,17946.0,4738,400,2991.6000000000004,3,2,1,6
4092,17947.0,333,81,1590.12,5,1,1,7
4093,17948.0,147,1,358.56000000000006,5,1,1,7
4094,17949.0,9930,4900,4095733.6000000006,2,4,5,11
4095,17950.0,16539,5041,34236.2,2,4,3,9
4096,17951.0,3726,400,20170.80000000001,3,2,3,8
4097,17954.0,92630,227529,1103840.01,1,5,5,11
4098,17955.0,4135,361,10588.699999999999,3,2,2,7
4099,17956.0,249,1,12.75,5,1,1,7
4100,17957.0,2046,961,3462.0800000000004,4,3,1,8
4101,17958.0,812,49,3559.2199999999993,5,1,1,7
4102,17960.0,4446,676,1918.28,3,2,1,6
4103,17961.0,59380,62001,322813.56,1,5,5,11
4104,17962.0,4828,1156,3481.94,3,3,1,7
4105,17964.0,14973,9604,45394.579999999994,2,4,3,9
4106,17965.0,64580,105625,844736.75,1,5,5,11
4107,17966.0,10328,4624,74693.23999999999,2,4,4,10
4108,17967.0,15582,1764,4715.339999999999,2,3,2,7
4109,17968.0,30213,6561,21473.100000000002,1,4,3,8
4110,17969.0,3689,196,3194.7999999999997,3,1,1,5
4111,17970.0,6119,841,16320.910000000002,3,2,3,8
4112,17972.0,7230,900,4055.7,3,3,2,8
4113,17973.0,765,225,5055.6,5,2,2,9
4114,17974.0,8345,27225,116158.35,2,5,4,11
4115,17975.0,58962,85849,1313595.1800000002,1,5,5,11
4116,17976.0,21204,3249,18342.030000000002,1,3,3,7
4117,17977.0,609,441,6050.94,5,2,2,9
4118,17978.0,4380,144,3611.04,3,1,1,5
4119,17979.0,22428,19044,101072.58,1,5,4,10
4120,17980.0,8289,900,24343.5,2,3,3,8
4121,17984.0,6960,2304,7328.64,3,3,2,8
4122,17985.0,462,441,13258.349999999999,5,2,2,9
4123,17986.0,56,1,20.8,5,1,1,7
4124,17987.0,2405,169,2581.41,4,1,1,6
4125,17988.0,6069,1444,7642.56,3,3,2,8
4126,17990.0,8304,841,18294.36,2,2,3,7
4127,17991.0,1127,25,466.75,5,1,1,7
4128,17994.0,19186,6241,53316.31,1,4,4,9
4129,17995.0,562,4,152.2,5,1,1,7
4130,17997.0,19426,26896,321843.44,1,5,5,11
4131,17999.0,15869,8281,34615.49,2,4,3,9
4132,18001.0,3718,3249,23662.41,3,3,3,9
4133,18004.0,13394,1369,5843.039999999998,2,3,2,7
4134,18005.0,1083,2809,12002.91,5,3,2,10
4135,18006.0,506,484,9782.960000000001,5,2,2,9
4136,18008.0,7799,900,63485.700000000004,3,3,4,10
4137,18009.0,7285,961,7669.089999999999,3,3,2,8
4138,18010.0,3584,196,2447.2,4,1,1,6
4139,18011.0,10444,784,2878.1200000000003,2,2,1,5
4140,18013.0,4805,961,5805.99,3,3,2,8
4141,18014.0,840,900,4866.6,5,3,2,10
4142,18015.0,184,2116,5521.380000000001,5,3,2,10
4143,18016.0,20660,14884,180274.52000000002,1,5,4,10
4144,18017.0,560,9,1569.0,5,1,1,7
4145,18018.0,3314,841,3542.06,4,2,1,7
4146,18019.0,255,25,192.25,5,1,1,7
4147,18022.0,5740,26896,100486.08,3,5,4,12
4148,18024.0,3192,441,8185.379999999999,4,2,2,8
4149,18027.0,2058,441,2421.51,4,2,1,7
4150,18030.0,188,81,2075.85,5,1,1,7
4151,18032.0,1670,25,367.5,4,1,1,6
4152,18033.0,2145,1089,3096.06,4,3,1,8
4153,18034.0,2310,12100,46054.79999999999,4,4,3,11
4154,18035.0,1915,2401,34980.61000000001,4,3,3,10
4155,18036.0,12775,8836,37893.280000000006,2,4,3,9
4156,18037.0,5216,361,1330.3799999999999,3,2,1,6
4157,18040.0,3073,361,6786.8,4,2,2,8
4158,18041.0,92491,209764,1876595.46,1,5,5,11
4159,18042.0,371,49,1155.35,5,1,1,7
4160,18043.0,29606,13225,60868.35,1,4,4,9
4161,18044.0,20705,16129,265252.2,1,5,5,11
4162,18045.0,1935,1849,7668.619999999998,4,3,2,9
4163,18048.0,1421,49,1206.0300000000002,4,1,1,6
4164,18050.0,1795,25,372.0,4,1,1,6
4165,18053.0,1400,400,6000.4000000000015,4,2,2,8
4166,18055.0,58455,128164,2420559.72,1,5,5,11
4167,18056.0,5472,361,6909.349999999999,3,2,2,7
4168,18058.0,27,9,510.48,5,1,1,7
4169,18059.0,869,361,5822.74,5,2,2,9
4170,18061.0,9561,2116,97492.85999999999,2,3,4,9
4171,18062.0,6196,729,19454.04,3,2,3,8
4172,18064.0,1135,49,5698.0,5,1,2,8
4173,18065.0,25014,18769,327817.70999999996,1,5,5,11
4174,18066.0,750,100,3180.0,5,1,1,7
4175,18067.0,1480,1369,14664.21,4,3,3,10
4176,18068.0,289,1,101.7,5,1,1,7
4177,18069.0,73042,208849,918222.68,1,5,5,11
4178,18071.0,7937,625,11325.0,3,2,2,7
4179,18072.0,3330,324,4453.92,4,2,2,8
4180,18073.0,10976,5184,277907.04000000004,2,4,5,11
4181,18074.0,4849,169,6364.8,3,1,2,6
4182,18075.0,26314,20164,370868.5,1,5,5,11
4183,18077.0,36871,49729,576323.4299999999,1,5,5,11
4184,18078.0,7175,841,9747.77,3,2,2,7
4185,18079.0,14372,15129,444417.45,2,5,5,12
4186,18080.0,260,4,2463.0,5,1,1,7
4187,18081.0,1519,289,5838.65,4,2,2,8
4188,18082.0,1750,4900,47658.799999999996,4,4,3,11
4189,18084.0,16,1,90.48,5,1,1,7
4190,18085.0,9957,841,20008.55,2,2,3,7
4191,18086.0,1918,49,709.38,4,1,1,6
4192,18087.0,388,4,8111.439999999999,5,1,2,8
4193,18088.0,2257,1369,6143.109999999999,4,3,2,9
4194,18092.0,14529,7921,807075.14,2,4,5,11
4195,18093.0,8432,1296,75834.72,2,3,4,9
4196,18094.0,13414,4900,211211.0,2,4,4,10
4197,18095.0,6872,441,12181.05,3,2,2,7
4198,18096.0,9280,38416,166415.75999999998,2,5,4,11
4199,18097.0,17292,11236,282214.4,2,4,5,11
4200,18099.0,2413,361,3197.89,4,2,1,7
4201,18101.0,2156,1600,8896.0,4,3,2,9
4202,18102.0,49068,185761,111912296.3,1,5,5,11
4203,18104.0,1406,1444,28676.320000000003,4,3,3,10
4204,18105.0,666,324,2042.6400000000003,5,2,1,8
4205,18106.0,12173,1369,15610.3,2,3,3,8
4206,18108.0,4318,289,4607.0,3,2,2,7
4207,18109.0,72394,194481,3530169.72,1,5,5,11
4208,18110.0,703,1369,7355.6,5,3,2,10
4209,18112.0,2160,676,9169.940000000002,4,2,2,8
4210,18113.0,368,1,76.32000000000001,5,1,1,7
4211,18114.0,8120,784,6162.8,2,2,2,6
4212,18116.0,103465,137641,520553.80999999994,1,5,5,11
4213,18117.0,1800,5184,22726.8,4,4,3,11
4214,18118.0,248047,1595169,7104476.04,1,5,5,11
4215,18119.0,10643,841,5240.299999999999,2,2,2,6
4216,18120.0,3638,289,1889.5500000000002,4,2,1,7
4217,18121.0,4764,961,20252.300000000003,3,3,3,9
4218,18122.0,14806,127449,640122.42,2,5,5,12
4219,18123.0,907,1156,19530.96,5,3,3,11
4220,18125.0,47497,36864,217296.0,1,5,4,10
4221,18126.0,3120,2704,10447.84,4,3,2,9
4222,18127.0,1786,2116,15965.679999999998,4,3,3,10
4223,18129.0,3402,196,1575.7,4,1,1,6
4224,18130.0,2335,4900,74157.3,4,4,4,12
4225,18133.0,212,1,931.5,5,1,1,7
4226,18135.0,2414,400,13638.2,4,2,2,8
4227,18136.0,9074,1444,29804.539999999994,2,3,3,8
4228,18138.0,2360,64,1221.2,4,1,1,6
4229,18139.0,2812,25281,1341696.06,4,5,5,14
4230,18142.0,2877,225,15292.8,4,2,3,9
4231,18143.0,7801,3721,61009.759999999995,3,4,4,11
4232,18144.0,8717,1849,124216.25000000001,2,3,4,9
4233,18145.0,25452,48841,632402.55,1,5,5,11
4234,18146.0,1720,100,1603.5,4,1,1,6
4235,18147.0,567,49,1255.3799999999997,5,1,1,7
4236,18149.0,3632,256,9793.279999999999,4,2,2,8
4237,18150.0,4846,1369,20963.460000000006,3,3,3,9
4238,18151.0,7727,1444,24827.299999999996,3,3,3,9
4239,18154.0,503,441,8382.99,5,2,2,9
4240,18155.0,4648,625,9290.500000000002,3,2,2,7
4241,18156.0,19314,14884,82428.08,1,5,4,10
4242,18158.0,2202,1156,15415.599999999999,4,3,3,10
4243,18159.0,6923,529,12193.450000000003,3,2,2,7
4244,18160.0,4940,1521,24884.340000000007,3,3,3,9
4245,18161.0,10709,6400,129495.20000000001,2,4,4,10
4246,18164.0,888,576,9591.599999999999,5,2,2,9
4247,18165.0,1770,100,3024.6000000000004,4,1,1,6
4248,18167.0,2025,1369,51239.82,4,3,4,11
4249,18168.0,37074,16900,150805.19999999998,1,5,4,10
4250,18169.0,540,81,1823.8500000000001,5,1,1,7
4251,18170.0,4779,1444,37251.78,3,3,3,9
4252,18171.0,10785,2916,66490.73999999999,2,3,4,9
4253,18172.0,33215,35721,1429157.52,1,5,5,11
4254,18173.0,6751,961,65312.040000000015,3,3,4,10
4255,18174.0,7,1,104.0,5,1,1,7
4256,18176.0,10740,900,14290.5,2,3,2,7
4257,18177.0,12789,5329,97883.51,2,4,4,10
4258,18178.0,22634,9409,154308.57,1,4,4,9
4259,18179.0,17882,8100,161385.30000000002,2,4,4,10
4260,18180.0,9954,14161,219406.25000000006,2,4,4,10
4261,18181.0,984,1681,15040.85,5,3,3,11
4262,18183.0,9292,1369,23386.590000000007,2,3,3,8
4263,18184.0,15,1,49.8,5,1,1,7
4264,18185.0,4233,289,5172.25,3,2,2,7
4265,18188.0,8069,5041,142073.84,2,4,4,10
4266,18189.0,12836,4624,74136.32000000002,2,4,4,10
4267,18190.0,4122,225,4266.9,3,2,2,7
4268,18191.0,1827,49,1454.6000000000001,4,1,1,6
4269,18192.0,3195,2025,43108.65,4,3,3,10
4270,18193.0,2640,256,3900.16,4,2,2,8
4271,18194.0,574,49,6816.88,5,1,2,8
4272,18196.0,28415,19321,95441.57000000002,1,5,4,10
4273,18198.0,29706,25281,862664.0400000002,1,5,5,11
4274,18200.0,3180,900,4510.5,4,3,2,9
4275,18202.0,16108,4624,94995.32000000002,2,4,4,10
4276,18203.0,2983,361,3047.9800000000005,4,2,1,7
4277,18204.0,25990,36864,379267.19999999995,1,5,5,11
4278,18205.0,1722,1024,16555.519999999997,4,3,3,10
4279,18209.0,224,64,1112.8000000000002,5,1,1,7
4280,18210.0,5828,17956,351264.92000000004,3,5,5,13
4281,18211.0,4577,1764,25202.940000000002,3,3,3,9
4282,18212.0,11084,1156,7346.38,2,3,2,7
4283,18213.0,3540,225,3487.2,4,2,1,7
4284,18215.0,1157,169,3891.4199999999996,5,1,2,8
4285,18216.0,806,676,12525.5,5,2,2,9
4286,18217.0,1678,961,19274.250000000004,4,3,3,10
4287,18218.0,5270,400,12838.400000000001,3,2,2,7
4288,18219.0,21016,12996,235953.78,1,4,5,10
4289,18220.0,452,4,610.5600000000001,5,1,1,7
4290,18221.0,8251,4096,66663.04,2,4,4,10
4291,18222.0,1748,361,8417.0,4,2,2,8
4292,18223.0,48501,73984,1763794.88,1,5,5,11
4293,18224.0,2630,100,1589.5000000000002,4,1,1,6
4294,18225.0,36798,72361,1480834.2400000002,1,5,5,11
4295,18226.0,40804,58564,1265188.1000000003,1,5,5,11
4296,18227.0,1085,25,468.75,5,1,1,7
4297,18228.0,2140,900,23397.0,4,3,3,10
4298,18229.0,25081,26896,1193411.5999999999,1,5,5,11
4299,18230.0,15390,7396,241677.19999999998,2,4,5,11
4300,18231.0,27950,15129,254827.70999999993,1,5,5,11
4301,18232.0,6309,1369,21939.89,3,3,3,9
4302,18233.0,325,1,440.0,5,1,1,7
4303,18235.0,12794,10816,186833.92,2,4,4,10
4304,18236.0,7063,2401,43229.76,3,3,3,9
4305,18237.0,5788,3721,60213.1,3,4,4,11
4306,18239.0,26442,7744,137421.68,1,4,4,9
4307,18240.0,276,36,2535.48,5,1,1,7
4308,18241.0,13085,10816,215601.36000000002,2,4,4,10
4309,18242.0,8993,6084,174134.21999999997,2,4,4,10
4310,18245.0,30685,30625,449235.50000000006,1,5,5,11
4311,18246.0,512,16,2384.3999999999996,5,1,1,7
4312,18248.0,7526,2209,37788.94,3,3,3,9
4313,18249.0,136,64,762.72,5,1,1,7
4314,18250.0,6510,441,7334.670000000001,3,2,2,7
4315,18251.0,1392,256,69035.52,4,2,4,10
4316,18252.0,5063,8836,48717.38,3,4,3,10
4317,18255.0,534,36,619.8,5,1,1,7
4318,18257.0,16340,13924,275840.34000000014,2,4,5,11
4319,18259.0,4683,1764,98221.20000000001,3,3,4,10
4320,18260.0,34384,17689,349570.54999999993,1,5,5,11
4321,18261.0,1683,441,6809.04,4,2,2,8
4322,18262.0,1820,169,1943.2399999999998,4,1,1,6
4323,18263.0,8830,3721,74002.76000000001,2,4,4,10
4324,18265.0,5806,2116,36869.46000000001,3,3,3,9
4325,18268.0,134,1,25.5,5,1,1,7
4326,18269.0,2562,49,1180.2,4,1,1,6
4327,18270.0,1558,121,3114.6500000000005,4,1,1,6
4328,18272.0,22455,27556,511044.27999999997,1,5,5,11
4329,18273.0,354,9,612.0,5,1,1,7
4330,18274.0,330,121,1935.1200000000001,5,1,1,7
4331,18276.0,602,196,4702.039999999999,5,1,2,8
4332,18277.0,464,64,883.04,5,1,1,7
4333,18278.0,657,81,1565.1,5,1,1,7
4334,18280.0,2770,100,1806.0,4,1,1,6
4335,18281.0,1260,49,565.74,5,1,1,7
4336,18282.0,917,144,2136.6000000000004,5,1,1,7
4337,18283.0,96925,519841,1474827.13,1,5,5,11
4338,18287.0,8159,4900,128609.59999999999,2,4,4,10
